id,date,new_cases,confirmed,new_deaths,total_deaths,new_tests,positive_tests,new_selftest,total_selftest,new_ag_tests,ag_tests,total_tests,new_critical,total_vaccinated_crit,total_unvaccinated_crit,total_critical,hospitalized,discharged,icu_out,icu_percent,beds_percent,new_active,active,recovered,total_foreign,total_domestic,total_unknown,total_vaccinations
1,2020-03-20,11,495,4,8,7172,485,0,0,0,0,7172,20,0,0,20,,,,,,487,487,19,0,0,0,
2,2020-03-21,10,530,3,13,658,547,0,0,0,0,7830,-2,0,0,18,,,,,,30,517,19,0,0,0,
3,2020-03-22,20,624,2,15,176,557,0,0,0,0,8006,16,0,0,34,,,,,,92,609,19,0,0,0,
4,2020-03-23,14,695,2,17,638,590,0,0,0,0,8644,0,0,0,34,,,,,,69,678,29,0,0,0,
5,2020-03-24,51,743,3,20,427,625,0,0,0,0,9071,11,0,0,45,,,,,,45,723,32,0,0,0,
6,2020-03-25,92,835,2,22,1424,745,0,0,0,0,10495,8,0,0,53,,,,,,90,813,36,0,0,0,
7,2020-03-26,71,892,4,26,0,0,0,0,0,0,10495,4,0,0,57,,,,,,53,866,42,0,0,0,
8,2020-03-27,74,966,2,28,2982,0,0,0,0,0,13477,13,0,0,70,,,,,,72,938,52,0,0,0,
9,2020-03-28,95,1061,4,32,886,0,0,0,0,0,14363,-1,0,0,69,,,,,,91,1029,52,0,0,0,
10,2020-03-29,95,1156,6,38,788,970,0,0,0,0,15151,0,0,0,69,,,,,,89,1118,53,0,0,0,
11,2020-03-30,56,1212,5,43,810,324,0,0,0,0,15961,3,0,0,72,,,,,,51,1169,53,0,0,0,
12,2020-03-31,102,1314,6,49,771,0,0,0,0,0,16732,13,0,0,85,,,,,,96,1265,53,0,0,0,
13,2020-04-01,101,1415,1,50,618,0,0,0,0,0,17350,5,0,0,90,,,,,,100,1365,53,0,0,0,
14,2020-04-02,27,1544,3,53,1494,0,0,0,0,0,18844,1,0,0,91,,,,,,126,1491,53,0,0,0,
15,2020-04-03,99,1613,6,59,3593,1524,0,0,0,0,22437,1,0,0,92,,,,,,-272,1219,0,335,563,715,
16,2020-04-04,60,1673,9,68,896,1577,0,0,0,0,23333,-1,0,0,91,,,,,,43,1262,0,343,592,738,
17,2020-04-05,62,1735,5,73,2120,1699,0,0,0,0,25453,2,0,0,93,,,,,,48,1310,0,352,617,766,
18,2020-04-06,20,1755,6,79,740,1694,0,0,0,0,26193,-3,0,0,90,,,,,,-482,828,0,361,655,739,
19,2020-04-07,77,1832,2,81,2391,1870,0,0,0,0,28584,0,0,0,90,,,,,,-95,733,0,501,679,652,
20,2020-04-08,52,1884,2,83,3944,2160,0,0,0,0,32528,-6,0,0,84,,,,,,-50,683,0,509,708,667,
21,2020-04-09,71,1955,3,86,1106,2220,0,0,0,0,33634,-5,0,0,79,,,,,,-10,673,0,518,734,703,
22,2020-04-10,54,2009,4,90,1798,2308,0,0,0,0,35432,-2,0,0,77,,,,,,-2,671,0,525,776,708,
23,2020-04-11,72,2081,3,93,1912,2417,0,0,0,0,37344,-2,0,0,75,,,,,,-31,640,0,535,796,750,
24,2020-04-12,33,2114,5,98,4917,0,0,0,0,0,42261,1,0,0,76,,,,,,-32,608,269,542,819,753,
25,2020-04-13,31,2145,1,99,1170,2668,0,0,0,0,43431,-3,0,0,73,,,,,,-54,554,0,554,856,735,
26,2020-04-14,25,2170,2,101,5367,2903,0,0,0,0,48798,3,0,0,76,,,,,,-69,485,0,555,869,746,
27,2020-04-15,22,2192,1,102,-1409,2809,0,0,0,0,47389,-4,0,0,72,,,,,,-72,413,0,559,899,734,
28,2020-04-16,15,2207,3,105,2001,2928,0,0,0,0,49390,-3,0,0,69,,,,,,-49,364,0,569,921,717,
29,2020-04-17,17,2224,3,108,2255,3020,0,0,0,0,51645,0,0,0,69,,,35,,,-81,283,0,568,927,729,
30,2020-04-18,11,2235,2,110,1645,3057,0,0,0,0,53290,-2,0,0,67,,,39,,,-93,190,0,570,943,722,
31,2020-04-19,0,2235,3,113,0,0,0,0,0,0,53290,0,0,0,67,,,39,,,440,630,0,0,0,0,
32,2020-04-20,10,2245,6,116,1054,3079,0,0,0,0,54344,-7,0,0,60,,,44,,,-291,339,0,571,950,724,
33,2020-04-21,156,2401,5,121,1322,3251,0,0,0,0,55666,-1,0,0,59,,,46,,,107,446,0,572,1111,718,
34,2020-04-22,7,2408,0,121,1326,3307,0,0,0,0,56992,-4,0,0,55,,,51,,,-42,404,0,573,1124,711,
35,2020-04-23,55,2463,4,125,2249,3405,0,0,0,0,59241,-3,0,0,52,,,57,,,45,449,0,574,1131,758,
36,2020-04-24,27,2490,5,130,2166,3459,0,0,0,0,61407,-4,0,0,48,,,60,,,81,530,0,580,1160,750,
37,2020-04-25,16,2506,0,130,1680,3505,0,0,0,0,63087,-1,0,0,47,,,63,,,-24,506,0,578,1174,754,
38,2020-04-26,11,2517,4,134,1521,3523,0,0,0,0,64608,-1,0,0,46,,,64,,,-52,454,0,578,1181,758,
39,2020-04-27,17,2534,2,136,1486,3544,0,0,0,0,66094,-3,0,0,43,,,65,,,-30,424,0,580,1228,726,
40,2020-04-28,32,2566,2,138,3739,3591,0,0,0,0,69833,-3,0,0,40,,,70,,,-37,387,0,588,1262,716,
41,2020-04-29,10,2576,1,139,2297,3630,0,0,0,0,72130,1,0,0,41,,,71,,,-13,374,0,589,1268,719,
42,2020-04-30,15,2591,1,140,3040,3658,0,0,0,0,75170,-3,0,0,38,,,74,,,-6,368,0,591,1286,714,
43,2020-05-01,21,2612,0,140,2081,3746,0,0,0,0,77251,-2,0,0,36,,,75,,,-3,365,0,593,1291,728,
44,2020-05-02,8,2620,3,143,956,3761,0,0,0,0,78207,1,0,0,37,,,77,,,-12,353,0,593,1301,726,
45,2020-05-03,6,2626,1,144,1125,3779,0,0,0,0,79332,0,0,0,37,,,78,,,1,354,0,595,1303,728,
46,2020-05-04,6,2632,2,146,1619,3794,0,0,0,0,80951,-2,0,0,35,,,81,,,-12,342,0,596,1313,723,
47,2020-05-05,10,2642,0,146,2799,3840,0,0,0,0,83750,0,0,0,35,,,81,,,1,343,0,598,1317,727,
48,2020-05-06,21,2663,1,147,3302,3905,0,0,0,0,87052,1,0,0,36,,,82,,,-552,-209,0,603,1326,734,
49,2020-05-07,15,2678,1,148,2991,3945,0,0,0,0,90043,-3,0,0,33,,,85,,,578,369,0,603,1340,735,
50,2020-05-08,13,2691,2,150,4248,3969,0,0,0,0,94291,-1,0,0,32,,,85,,,-139,230,0,603,1349,739,
51,2020-05-09,19,2710,1,151,3093,4003,0,0,0,0,97384,-4,0,0,28,,,86,,,12,242,0,603,1358,749,
52,2020-05-10,6,2716,0,151,1493,4015,0,0,0,0,98877,2,0,0,30,,,87,,,-44,198,0,603,1364,749,
53,2020-05-11,10,2726,0,151,486,3974,0,0,0,0,99363,2,0,0,32,,,87,,,-10,188,0,607,1374,745,
54,2020-05-12,18,2744,1,152,6691,4053,0,0,0,0,106054,0,0,0,32,,,88,,,-4,184,0,610,1388,746,
55,2020-05-13,16,2760,3,155,5988,4179,0,0,0,0,112042,-4,0,0,28,,,88,,,6,190,0,610,1402,748,
56,2020-05-14,10,2770,1,156,4191,4256,0,0,0,0,116233,-4,0,0,24,,,90,,,-4,186,0,610,1409,751,
57,2020-05-15,40,2810,4,160,3782,4309,0,0,0,0,120015,-1,0,0,23,,,90,,,12,198,0,612,1452,746,
58,2020-05-16,9,2819,2,162,6268,4391,0,0,0,0,126283,0,0,0,23,,,90,,,-2,196,0,613,1455,751,
59,2020-05-17,15,2834,1,163,2242,4412,0,0,0,0,128525,-1,0,0,22,,,90,,,-1,195,0,616,1466,752,
60,2020-05-18,2,2836,2,165,3159,4442,0,0,0,0,131684,2,0,0,24,,,90,,,-19,176,0,616,1473,747,
61,2020-05-19,4,2840,0,165,4317,4477,0,0,0,0,136001,-2,0,0,22,,,95,,,-1,175,0,616,1475,749,
62,2020-05-20,10,2850,1,166,3444,4515,0,0,0,0,139445,0,0,0,22,,,96,,,5,180,0,617,1476,757,
63,2020-05-21,3,2853,1,168,4633,4540,0,0,0,0,144078,-1,0,0,21,,,98,,,3,183,0,612,1436,805,
64,2020-05-22,21,2873,1,169,3880,4591,0,0,0,0,147958,-2,0,0,19,,,98,,,11,194,0,612,1446,815,
65,2020-05-23,3,2876,2,171,5040,4606,0,0,0,0,152998,1,0,0,20,,,99,,,-15,179,0,613,1458,805,
66,2020-05-24,2,2878,0,171,965,4612,0,0,0,0,153963,-1,0,0,19,,,100,,,-25,154,0,626,1635,617,
67,2020-05-25,4,2882,1,172,1074,4630,0,0,0,0,155037,-1,0,0,18,,,101,,,-9,145,0,627,1640,615,
68,2020-05-26,7,2889,1,173,5954,4689,0,0,0,0,160991,0,0,0,18,,,101,,,-13,132,0,628,1644,617,
69,2020-05-27,18,2903,0,173,5254,4728,0,0,0,0,166245,-1,0,0,17,,,102,,,9,141,0,627,1645,631,
70,2020-05-28,3,2906,2,175,4222,4759,0,0,0,0,170467,-1,0,0,16,,,102,,,-8,133,0,630,1658,618,
71,2020-05-29,5,2909,0,175,4377,4781,0,0,0,0,174844,0,0,0,16,,,105,,,-12,121,0,631,1660,618,
72,2020-05-30,7,2915,0,175,3472,4800,0,0,0,0,178316,-2,0,0,14,,,106,,,-10,111,0,634,1696,585,
73,2020-05-31,2,2917,0,175,2202,4803,0,0,0,0,180518,-1,0,0,13,,,106,,,-9,102,0,636,1696,585,
74,2020-06-01,2,2918,4,179,1905,4811,0,0,0,0,182423,-1,0,0,12,,,106,,,-38,64,0,637,1695,586,
75,2020-06-02,19,2937,0,179,3167,4825,0,0,0,0,185590,-1,0,0,11,,,107,,,-1,63,0,651,1695,591,
76,2020-06-03,0,2937,0,179,0,0,0,0,0,0,185590,-11,0,0,0,,,,,,23,86,0,0,0,0,
77,2020-06-04,15,2952,1,180,8339,4854,0,0,0,0,193929,9,0,0,9,,,108,,,-21,65,0,652,1702,598,
78,2020-06-05,0,2952,0,180,0,0,0,0,0,0,193929,-9,0,0,0,,,,,,31,96,0,0,0,0,
79,2020-06-06,0,2952,0,180,0,0,0,0,0,0,193929,0,0,0,0,,,,,,-9,87,0,0,0,0,
80,2020-06-07,0,2952,0,180,0,0,0,0,0,0,193929,0,0,0,0,,,,,,-1,86,0,0,0,0,
81,2020-06-08,97,3049,2,182,35590,5005,0,0,0,0,229519,10,0,0,10,,,115,,,-1,85,0,690,1735,624,
82,2020-06-09,9,3058,1,183,2240,5016,0,0,0,0,231759,0,0,0,10,,,115,,,8,93,0,690,1740,628,
83,2020-06-10,11,3068,0,183,9165,5058,0,0,0,0,240924,2,0,0,12,,,115,,,19,112,0,692,1751,625,
84,2020-06-11,20,3088,0,183,-3648,5062,0,0,0,0,237276,2,0,0,14,,,115,,,18,130,0,692,1752,644,
85,2020-06-12,20,3108,0,183,6591,5100,0,0,0,0,243867,0,0,0,14,,,116,,,13,143,0,694,1768,646,
86,2020-06-13,4,3112,0,183,3585,5114,0,0,0,0,247452,-1,0,0,13,,,116,,,-11,132,0,694,1774,644,
87,2020-06-14,9,3121,0,183,3471,5120,0,0,0,0,250923,0,0,0,13,,,116,,,11,143,0,694,1775,652,
88,2020-06-15,13,3134,1,184,3931,5126,0,0,0,0,254854,0,0,0,13,,,117,,,7,150,0,697,1781,656,
89,2020-06-16,15,3148,1,185,4882,5165,0,0,0,0,259736,-1,0,0,12,,,117,,,9,159,0,698,1786,664,
90,2020-06-17,55,3203,2,187,5194,5219,0,0,0,0,264930,-1,0,0,11,,,117,,,53,212,0,698,1796,709,
91,2020-06-18,24,3227,1,188,5408,5249,0,0,0,0,270338,-1,0,0,10,,,117,,,22,234,0,703,1804,720,
92,2020-06-19,10,3237,1,189,4373,5265,0,0,0,0,274711,0,0,0,10,,,117,,,-6,231,0,707,1813,717,
93,2020-06-20,19,3256,1,190,4184,5287,0,0,0,0,278895,-1,0,0,9,,,117,,,-639,-408,0,716,1822,718,
94,2020-06-21,10,3266,0,190,4251,5294,0,0,0,0,283146,0,0,0,9,,,117,,,644,236,0,720,1826,720,
95,2020-06-22,21,3287,0,190,2843,5279,0,0,0,0,285989,-1,0,0,8,,,118,,,-636,-400,0,725,1836,726,
96,2020-06-23,16,3302,0,190,5198,5353,0,0,0,0,291187,0,0,0,8,,,118,,,12,-388,0,728,1844,730,
97,2020-06-24,8,3310,0,190,4452,5367,0,0,0,0,295639,0,0,0,8,,,118,,,6,-382,0,730,1848,732,
98,2020-06-25,13,3321,1,191,-3799,5386,0,0,0,0,291840,1,0,0,9,,,119,,,601,219,0,734,1851,736,
99,2020-06-26,22,3343,0,191,4011,5413,0,0,0,0,295851,2,0,0,11,,,119,,,3,222,0,745,1861,737,
100,2020-06-27,23,3366,0,191,5293,5437,0,0,0,0,301144,0,0,0,11,,,119,,,7,229,0,753,1873,740,
101,2020-06-28,10,3376,0,191,3993,5447,0,0,0,0,305137,-1,0,0,10,,,119,,,-11,218,0,754,1880,742,
102,2020-06-29,15,3390,0,191,3255,5478,0,0,0,0,308392,0,0,0,10,,,119,,,-7,211,0,757,1881,752,
103,2020-06-30,20,3409,1,192,4383,5508,0,0,0,0,312775,-1,0,0,9,,,118,,,5,216,0,766,1900,743,
104,2020-07-01,23,3432,0,192,3207,5552,0,0,0,0,315982,0,0,0,9,,,119,,,3,219,0,777,1906,749,
105,2020-07-02,28,3458,0,192,4445,5594,0,0,0,0,320427,-1,0,0,8,,,118,,,9,228,0,785,1914,759,
106,2020-07-03,28,3486,0,192,5024,5570,0,0,0,0,325451,0,0,0,8,,,119,,,2,230,0,799,1922,765,
107,2020-07-04,25,3511,0,192,6252,5655,0,0,0,0,331703,3,0,0,11,,,119,,,-39,191,0,810,1933,768,
108,2020-07-05,9,3519,0,192,5451,5662,0,0,0,0,337154,0,0,0,11,,,119,,,-16,175,0,816,1933,770,
109,2020-07-06,43,3562,0,192,3174,5716,0,0,0,0,340328,0,0,0,11,,,120,,,2,177,0,852,1936,774,
110,2020-07-07,27,3589,1,193,8756,5750,0,0,0,0,349084,-1,0,0,10,,,121,,,1,178,0,868,1941,780,
111,2020-07-08,33,3622,0,193,6106,5786,0,0,0,0,355190,-1,0,0,9,,,121,,,3,181,0,892,1946,784,
112,2020-07-09,50,3672,0,193,3535,5839,0,0,0,0,358725,0,0,0,9,,,121,,,7,188,0,919,1948,805,
113,2020-07-10,60,3732,0,193,4687,5894,0,0,0,0,363412,0,0,0,9,,,121,,,5,193,0,962,1962,808,
114,2020-07-11,41,3772,0,193,7755,5934,0,0,0,0,371167,0,0,0,9,,,122,,,6,199,0,990,1969,813,
115,2020-07-12,31,3803,0,193,2765,5961,0,0,0,0,373932,1,0,0,10,,,122,,,17,216,0,998,1989,816,
116,2020-07-13,24,3826,0,193,8520,5993,0,0,0,0,382452,2,0,0,12,,,122,,,3,219,0,1007,2002,817,
117,2020-07-14,58,3883,0,193,3855,6041,0,0,0,0,386307,1,0,0,13,,,122,,,7,226,0,1042,2019,822,
118,2020-07-15,27,3910,0,193,5466,6067,0,0,0,0,391773,0,0,0,13,,,122,,,9,235,0,1051,2024,835,
119,2020-07-16,35,3939,0,193,6574,6099,0,0,0,0,398347,1,0,0,14,,,123,,,11,415,0,1069,2035,835,
120,2020-07-17,28,3964,1,194,4325,6120,0,0,0,0,402672,-2,0,0,12,,,124,,,-181,234,0,1085,2035,844,
121,2020-07-18,19,3983,0,194,3368,6146,0,0,0,0,406040,0,0,0,12,,,124,,,4,238,0,1088,2044,851,
122,2020-07-19,24,4007,0,194,4726,6162,0,0,0,0,410766,1,0,0,13,,,124,,,-12,226,0,1106,2048,853,
123,2020-07-20,11,4012,1,195,2994,6172,0,0,0,0,413760,-1,0,0,12,,,124,,,-16,210,0,1112,2051,849,
124,2020-07-21,36,4048,2,197,6146,6212,0,0,0,0,419906,-2,0,0,10,,,124,,,14,224,0,1118,2059,871,
125,2020-07-22,32,4077,3,200,4769,6238,0,0,0,0,424675,0,0,0,10,,,124,,,14,238,0,1128,2066,883,
126,2020-07-23,33,4110,1,201,6189,6254,0,0,0,0,430864,-2,0,0,8,,,125,,,9,247,0,1144,2072,894,
127,2020-07-24,26,4135,0,201,5646,6202,0,0,0,0,436510,0,0,0,8,,,127,,,4,251,0,1155,2086,894,
128,2020-07-25,31,4166,0,201,3646,6287,0,0,0,0,440156,2,0,0,10,,,127,,,11,262,0,1166,2095,905,
129,2020-07-26,27,4193,1,202,7529,6298,0,0,0,0,447685,-1,0,0,9,,,127,,,-5,257,0,1174,2101,918,
130,2020-07-27,35,4227,0,202,3632,6339,0,0,0,0,451317,0,0,0,9,,,127,,,7,264,0,1184,2118,925,
131,2020-07-28,52,4279,1,203,6223,6395,0,0,0,0,457540,-1,0,0,8,,,127,,,28,292,0,1195,2139,945,
132,2020-07-29,57,4336,0,203,53889,6442,0,0,0,0,511429,0,0,0,8,,,127,,,17,309,0,1212,2157,3124,
133,2020-07-30,65,4401,0,203,8458,6490,0,0,0,0,519887,-1,0,0,7,,,128,,,13,322,0,1250,2192,959,
134,2020-07-31,78,4477,3,206,9968,6553,0,0,0,0,529855,2,0,0,9,,,127,,,34,356,0,1267,2218,992,
135,2020-08-01,110,4587,0,206,9638,6604,0,0,0,0,539493,1,0,0,10,,,128,,,79,435,0,1280,2252,1055,
136,2020-08-02,75,4662,2,208,5946,6657,0,0,0,0,545439,2,0,0,12,,,128,,,52,487,0,1290,2308,1064,
137,2020-08-03,77,4737,1,209,19417,6731,0,0,0,0,564856,1,0,0,13,,,128,,,53,540,0,1303,2345,1089,
138,2020-08-04,121,4855,0,209,34853,6796,0,0,0,0,599709,0,0,0,13,,,129,,,80,620,0,1325,2403,1127,
139,2020-08-05,124,4973,1,210,9874,6876,0,0,0,0,609583,0,0,0,13,,,129,,,87,707,0,1349,2479,1145,
140,2020-08-06,153,5123,0,210,9810,6973,0,0,0,0,619393,1,0,0,14,,,129,,,131,838,0,1370,2551,1202,
141,2020-08-07,151,5270,0,210,11590,7098,0,0,0,0,630983,0,0,0,14,,,129,,,110,948,0,1379,2611,1280,
142,2020-08-08,152,5421,1,211,9314,7183,0,0,0,0,640297,3,0,0,17,,,129,,,108,1056,0,1405,2645,1371,
143,2020-08-09,203,5623,1,212,10701,7274,0,0,0,0,650998,5,0,0,22,,,129,,,152,1208,0,1438,2705,1480,
144,2020-08-10,126,5749,1,213,7180,7365,0,0,0,0,658178,2,0,0,24,,,129,,,76,1284,0,1473,2795,1481,
145,2020-08-11,196,5942,1,214,10561,7489,0,0,0,0,668739,2,0,0,26,,,130,,,142,1426,0,1503,2885,1554,
146,2020-08-12,262,6177,2,216,11046,7616,0,0,0,0,679785,-2,0,0,24,,,132,,,190,1616,0,1528,3002,1647,
147,2020-08-13,204,6381,5,221,7553,7866,0,0,0,0,687338,-2,0,0,22,,,136,,,146,1762,0,1557,3110,1714,
148,2020-08-14,254,6632,2,223,17583,8059,0,0,0,0,704921,0,0,0,22,,,136,,,174,1936,0,1592,3207,1833,
149,2020-08-15,230,6858,3,226,10582,8184,0,0,0,0,715503,1,0,0,23,,,136,,,127,2063,0,1648,3293,1917,
150,2020-08-16,217,7075,2,228,3808,8158,0,0,0,0,719311,1,0,0,24,,,136,,,169,2232,0,1667,3353,2055,
151,2020-08-17,150,7222,2,230,7650,8256,0,0,0,0,726961,-1,0,0,23,,,136,,,64,2296,0,1692,3394,2136,
152,2020-08-18,269,7472,2,232,13910,8361,0,0,0,0,740871,2,0,0,25,,,137,,,101,2397,0,1742,3516,2214,
153,2020-08-19,217,7684,3,235,63411,8637,0,0,0,0,804282,3,0,0,28,,,140,,,123,2520,0,1765,3585,2334,
154,2020-08-20,269,7934,0,235,12168,8752,0,0,0,0,816450,2,0,0,30,,,140,,,171,2691,0,1783,3658,2493,
155,2020-08-21,209,8138,3,238,10354,8906,0,0,0,0,826804,-2,0,0,28,,,143,,,86,2777,0,1802,3752,2584,
156,2020-08-22,264,8381,2,240,11211,9190,0,0,0,0,838015,3,0,0,31,,,143,,,118,2895,0,1832,3842,2707,
157,2020-08-23,284,8664,2,242,10365,9366,0,0,0,0,848380,0,0,0,31,,,143,,,132,3027,0,1852,3940,2872,
158,2020-08-24,170,8819,0,242,9758,9453,0,0,0,0,858138,0,0,0,31,,,143,,,-17,3010,0,1886,4009,2924,
159,2020-08-25,168,8987,1,243,14412,9668,0,0,0,0,872550,0,0,0,31,,,143,,,19,3029,0,1910,4074,3003,
160,2020-08-26,293,9280,5,248,15441,9917,0,0,0,0,887991,2,0,0,33,,,145,,,87,3116,0,1943,4179,3158,
161,2020-08-27,259,9531,6,254,15441,10103,0,0,0,0,903432,2,0,0,35,,,147,,,123,3239,0,1975,4271,3285,
162,2020-08-28,270,9800,5,259,13833,10342,0,0,0,0,917265,0,0,0,35,,,147,,,65,3304,0,2012,4347,3441,
163,2020-08-29,177,9977,1,260,13737,10436,0,0,0,0,931002,1,0,0,36,,,148,,,-53,3251,0,2033,4402,3542,
164,2020-08-30,157,10134,2,262,9880,10586,0,0,0,0,940882,-1,0,0,35,,,149,,,-60,3191,0,2078,4448,3608,
165,2020-08-31,183,10317,4,266,8485,10599,0,0,0,0,949367,1,0,0,36,,,153,,,-46,3145,0,2089,4570,3658,
166,2020-09-01,207,10524,5,271,16979,10891,0,0,0,0,966346,2,0,0,38,,,153,,,12,3157,0,2112,4710,3702,
167,2020-09-02,233,10757,2,273,14154,11017,0,0,0,0,980500,0,0,0,38,,,154,,,6,3163,0,2141,4779,3837,
168,2020-09-03,241,10998,5,278,12066,11176,0,0,0,0,992566,1,0,0,39,,,154,,,83,3246,0,2174,4843,3981,
169,2020-09-04,202,11200,1,279,10576,11281,0,0,0,0,1003142,-1,0,0,38,,,157,,,-11,3235,0,2188,4910,4102,
170,2020-09-05,187,11386,1,280,11922,11401,0,0,0,0,1015064,2,0,0,40,,,157,,,-32,3203,0,2219,4970,4197,
171,2020-09-06,144,11524,4,284,12554,11465,0,0,0,0,1027618,1,0,0,41,,,161,,,-124,3079,0,2245,5017,4262,
172,2020-09-07,156,11663,5,289,10218,11465,0,0,0,0,1037836,1,0,0,42,,,160,,,-61,3018,0,2258,5065,4340,
173,2020-09-08,169,11832,1,290,12423,11465,0,0,0,0,1050259,0,0,0,42,,,164,,,-59,2959,0,2274,5204,4354,
174,2020-09-09,248,12080,3,293,16046,11465,0,0,0,0,1066305,4,0,0,46,,,167,,,-39,2920,0,2297,5296,4487,
175,2020-09-10,372,12452,4,297,16096,11465,0,0,0,0,1082401,3,0,0,49,,,167,,,220,3140,0,2324,5511,4617,
176,2020-09-11,287,12734,3,300,11953,11465,0,0,0,0,1094354,3,0,0,52,,,169,,,120,3260,0,2340,5601,4793,
177,2020-09-12,302,13036,2,302,18638,11465,0,0,0,0,1112992,1,0,0,53,,,170,,,22,3282,0,2363,5649,5024,
178,2020-09-13,207,13240,3,305,12890,11465,0,0,0,0,1125882,1,0,0,54,,,171,,,-43,3239,0,2394,5710,5136,
179,2020-09-14,180,13420,5,310,7145,11465,0,0,0,0,1133027,5,0,0,59,,,173,,,-77,3162,0,2419,5789,5212,
180,2020-09-15,310,13730,3,313,11522,11465,0,0,0,0,1144549,8,0,0,67,,,175,,,138,3300,0,2433,5901,5396,
181,2020-09-16,312,14041,3,316,13348,11465,0,0,0,0,1157897,0,0,0,67,,,176,,,169,3469,0,2462,5972,5607,
182,2020-09-17,359,14400,9,325,12395,11465,0,0,0,0,1170292,2,0,0,69,,,178,,,144,3613,0,2500,6070,5830,
183,2020-09-18,339,14738,2,327,11420,11465,0,0,0,0,1181712,2,0,0,71,,,177,,,116,3729,0,2541,6191,6006,
184,2020-09-19,240,14978,4,331,12301,11465,0,0,0,0,1194013,-6,0,0,65,,,177,,,-1,3728,0,2576,6297,6105,
185,2020-09-20,170,15142,7,338,8200,11465,0,0,0,0,1202213,13,0,0,78,,,177,,,-61,3667,0,2591,6348,6203,
186,2020-09-21,453,15595,6,344,7905,11465,0,0,0,0,1210118,1,0,0,79,,,181,,,233,3900,0,2618,6592,6385,
187,2020-09-22,346,15928,8,352,10899,11465,0,0,0,0,1221017,-2,0,0,77,,,185,,,138,4038,0,2651,6687,6590,
188,2020-09-23,358,16286,5,357,12212,11465,0,0,0,0,1233229,-4,0,0,73,,,191,,,200,4238,0,2696,6808,6782,
189,2020-09-24,342,16627,9,366,13134,11465,0,0,0,0,1246363,-5,0,0,68,,,192,,,181,4419,0,2726,6915,6986,
190,2020-09-25,286,16913,3,369,10073,11465,0,0,0,0,1256436,-5,0,0,63,,,197,,,94,4513,0,2763,7028,7122,
191,2020-09-26,315,17228,7,376,12619,11465,0,0,8879,8879,1269055,5,0,0,68,,,199,,,66,4579,0,2783,7131,7314,
192,2020-09-27,218,17444,3,379,9532,11465,0,0,434,9313,1278587,0,0,0,68,,,200,,,-170,4409,0,2825,7242,7377,
193,2020-09-28,269,17707,4,383,6107,11465,0,0,589,9902,1284694,5,0,0,73,,,201,,,-16,4393,0,2837,7349,7521,
194,2020-09-29,416,18123,5,388,12101,11465,0,0,817,10719,1296795,6,0,0,79,,,207,,,73,4466,0,2898,7479,7746,
195,2020-09-30,354,18475,3,391,10754,11465,0,0,785,11504,1307549,-1,0,0,78,,,212,,,150,4616,0,2927,7598,7950,
196,2020-10-01,411,18886,2,393,10787,11465,0,0,784,12288,1318336,11,0,0,89,,,214,,,225,4841,0,2961,7755,8170,
197,2020-10-02,460,19346,5,398,9706,11465,0,0,812,13100,1328042,-4,0,0,85,,,217,,,132,4973,0,2991,7967,8388,
198,2020-10-03,267,19613,7,405,11622,11465,0,0,971,14071,1339664,-6,0,0,79,,,219,,,-47,4926,0,3019,8025,8569,
199,2020-10-04,229,19842,4,409,9459,11465,0,0,948,15019,1349123,3,0,0,82,,,223,,,-117,4809,0,3049,8083,8710,
200,2020-10-05,303,20142,8,417,6013,11465,0,0,1272,16291,1355136,1,0,0,83,,,227,,,-36,4773,0,3082,8232,8828,
201,2020-10-06,399,20541,3,420,12095,11465,0,0,1063,17354,1367231,4,0,0,87,,,229,,,155,4928,0,3122,8385,9034,
202,2020-10-07,407,20947,4,424,11805,11465,0,0,1291,18645,1379036,1,0,0,88,,,232,,,232,5160,0,3150,8559,9238,
203,2020-10-08,436,21381,6,430,11234,11465,0,0,1434,20079,1390270,3,0,0,91,,,236,,,-12,5148,0,3170,8727,9484,
204,2020-10-09,391,21772,1,431,10587,11465,0,0,1827,21906,1400857,7,0,0,98,,,237,,,55,5203,0,3213,8892,9667,
205,2020-10-10,306,22078,5,436,12981,11465,0,0,2420,24326,1413838,2,0,0,100,,,238,,,-39,5164,0,3245,9002,9831,
206,2020-10-11,280,22358,13,449,9162,11465,0,0,1195,25521,1423000,-7,0,0,93,,,238,,,-61,5103,0,3271,9093,9994,
207,2020-10-12,295,22652,7,456,6670,11465,0,0,296,25817,1429670,-2,0,0,91,,,240,,,-3,5100,0,3315,9218,10119,
208,2020-10-13,408,23060,6,462,19561,11465,0,0,1259,27076,1449231,-2,0,0,89,,,242,,,62,5162,0,3367,9364,10329,
209,2020-10-14,436,23495,7,469,20126,11465,0,0,1405,28481,1469357,-3,0,0,86,,,245,,,220,5382,0,3404,9525,10566,
210,2020-10-15,453,23947,13,482,19856,11465,0,0,2106,30587,1489213,-4,0,0,82,,,245,,,162,5544,0,3434,9698,10815,
211,2020-10-16,508,24450,8,490,19247,11465,0,0,2034,32621,1508460,-1,0,0,81,,,255,,,125,5669,0,3454,9893,11103,
212,2020-10-17,482,24932,10,500,18798,11465,0,0,2331,34952,1527258,2,0,0,83,,,256,,,131,5800,0,3475,10037,11420,
213,2020-10-18,438,25370,9,509,14898,11465,0,0,616,35568,1542156,1,0,0,84,,,256,,,21,5821,0,3508,10153,11709,
214,2020-10-19,438,25802,11,520,7236,11465,0,0,288,35856,1549392,1,0,0,85,,,258,,,-56,5765,0,3560,10337,11905,
215,2020-10-20,667,26469,8,528,19406,11465,0,0,1986,37842,1568798,2,0,0,87,,,260,,,374,6139,0,3613,10539,12317,
216,2020-10-21,865,27334,6,534,19915,11465,0,0,3985,41827,1588713,-1,0,0,86,,,265,,,605,6744,0,3672,10802,12860,
217,2020-10-22,882,28216,15,549,20327,11465,0,0,2873,44700,1609040,4,0,0,90,,,265,,,552,7296,0,3728,11032,13456,
218,2020-10-23,841,29057,10,559,20449,11465,0,0,3562,48262,1629489,-1,0,0,89,,,268,,,426,7722,0,3777,11354,13926,
219,2020-10-24,935,29992,5,564,20072,11465,0,0,2584,50846,1649561,2,0,0,91,,,270,,,505,8227,0,3828,11532,14632,
220,2020-10-25,790,30782,10,574,16590,11465,0,0,2046,52892,1666151,-7,0,0,84,,,272,,,338,8565,0,3862,11724,15196,
221,2020-10-26,715,31496,7,581,11978,11465,0,0,1815,54707,1678129,11,0,0,95,,,275,,,339,8904,0,3883,12194,15419,
222,2020-10-27,1259,32752,12,593,20198,11465,0,0,2949,57656,1698327,7,0,0,102,,,277,,,908,9812,0,3950,12381,16421,
223,2020-10-28,1547,34299,10,603,20123,11465,0,0,4128,61784,1718450,6,0,0,108,,,280,,,1243,11055,0,4003,12552,17744,
224,2020-10-29,1211,35510,12,615,12069,11465,0,0,894,62678,1730519,6,0,0,114,,,284,,,916,11971,0,4043,12843,18624,
225,2020-10-30,1690,37196,5,620,23323,11465,0,0,6218,68896,1753842,14,0,0,128,,,286,,,1291,13262,0,4083,13107,20006,
226,2020-10-31,2056,39251,6,626,23480,11465,0,0,2705,71601,1777322,7,0,0,135,,,291,,,1629,14891,0,4112,13278,21861,
227,2020-11-01,1678,40929,9,635,14708,11465,0,0,1398,72999,1792030,5,0,0,140,,,291,,,1235,16126,0,4137,13493,23299,
228,2020-11-02,1152,42080,7,642,11986,11465,0,0,1519,74518,1804016,13,0,0,153,,,294,,,630,16756,0,4176,13821,24083,
229,2020-11-03,2166,44246,13,655,25075,11465,0,0,2913,77431,1829091,16,0,0,169,,,300,,,1653,18409,0,4225,14111,25910,
230,2020-11-04,2646,46892,18,673,24204,11465,0,0,3084,80515,1853295,10,0,0,179,,,305,,,2186,20595,0,4271,14427,28194,
231,2020-11-05,2917,49807,29,702,23176,11465,0,0,3052,83567,1876471,8,0,0,187,,,310,,,2485,23080,0,4303,14879,30625,
232,2020-11-06,2448,52254,14,715,25987,11465,0,0,3603,87170,1902458,9,0,0,196,,,315,,,1762,24842,0,4369,15192,32693,
233,2020-11-07,2556,54809,34,749,24086,11465,0,0,3797,90967,1926544,11,0,0,207,,,315,,,1704,26546,0,4386,15400,35023,
234,2020-11-08,1914,56698,35,784,15112,11465,0,0,1022,91989,1941656,21,0,0,228,,,323,,,1000,27546,0,4429,15678,36591,
235,2020-11-09,1490,58187,41,825,10687,11465,0,0,634,92623,1952343,11,0,0,239,,,329,,,639,28185,0,4456,15977,37754,
236,2020-11-10,2384,60570,41,866,25217,11465,0,0,2598,95221,1977560,24,0,0,263,,,336,,,1409,29594,0,4510,16382,39678,
237,2020-11-11,2752,63321,43,909,25714,11465,0,0,3476,98697,2003274,34,0,0,297,,,347,,,1916,31510,0,4556,17036,41729,
238,2020-11-12,3316,66637,50,959,24922,11465,0,0,3672,102369,2028196,13,0,0,310,,,353,,,2549,34059,0,4587,17773,44277,
239,2020-11-13,3038,69675,38,997,24970,11465,0,0,4465,106834,2053166,26,0,0,336,,,362,,,1809,35868,0,4601,18334,46740,
240,2020-11-14,2835,72510,38,1035,24896,11465,0,0,3947,110781,2078062,30,0,0,366,,,370,,,1292,37160,0,4622,18812,49076,
241,2020-11-15,1698,74205,71,1106,14262,11465,0,0,1635,112416,2092324,26,0,0,392,,,376,,,439,37599,0,4648,19081,50476,
242,2020-11-16,2198,76403,59,1165,11911,11465,0,0,1237,113653,2104235,8,0,0,400,,,383,,,471,38070,0,4675,19638,52090,
243,2020-11-17,2422,78825,63,1228,23954,11465,0,0,5844,119497,2128189,43,0,0,443,,,392,,,329,38399,0,4685,20225,53915,
244,2020-11-18,3209,82034,60,1288,25765,11465,0,0,6012,125509,2153954,37,0,0,480,,,410,,,1476,39875,0,4714,20917,56403,
245,2020-11-19,3227,85261,59,1347,23325,11465,0,0,7746,133255,2177279,19,0,0,499,,,426,,,2052,41927,0,4725,21605,58931,
246,2020-11-20,2581,87812,72,1419,23148,11465,0,0,7982,141237,2200427,20,0,0,519,,,440,,,334,42261,0,4766,22295,60751,
247,2020-11-21,2311,90121,108,1527,22798,11465,0,0,8122,149359,2223225,3,0,0,522,,,460,,,-402,41859,0,4787,22901,62433,
248,2020-11-22,1498,91619,103,1630,12698,11465,0,0,3105,152464,2235923,18,0,0,540,,,470,,,-1482,40377,0,4810,23403,63406,
249,2020-11-23,1388,93006,84,1714,11209,11465,0,0,4289,156753,2247132,9,0,0,549,,,482,,,-1078,39299,0,4823,23998,64185,
250,2020-11-24,2135,95137,101,1815,22166,11465,0,0,10081,166834,2269298,13,0,0,562,,,490,,,-491,38808,0,4840,24679,65618,
251,2020-11-25,2152,97288,87,1902,21361,11465,0,0,9652,176486,2290659,35,0,0,597,,,505,,,244,39052,0,4849,25291,67148,
252,2020-11-26,2018,99306,99,2001,21211,11465,0,0,10307,186793,2311870,11,0,0,608,,,524,,,496,39548,0,4851,25924,68531,
253,2020-11-27,2013,101287,101,2102,21061,11465,0,0,9784,196577,2332931,-1,0,0,607,,,538,,,-422,39126,0,4865,26718,69704,
254,2020-11-28,1747,103034,121,2223,21112,11465,0,0,8342,204919,2354043,-1,0,0,606,,,557,,,-1038,38088,0,4867,27199,70968,
255,2020-11-29,1193,104227,98,2321,12320,11465,0,0,4106,209025,2366363,-3,0,0,603,,,575,,,-2152,35936,0,4879,27746,71602,
256,2020-11-30,1044,105271,85,2406,7203,11465,0,0,4169,213194,2373566,-3,0,0,600,,,581,,,-2036,33900,0,4888,28075,72308,
257,2020-12-01,2199,107470,111,2517,21032,11465,0,0,9891,223085,2394598,-4,0,0,596,,,597,,,-719,33181,0,4919,28590,73961,
258,2020-12-02,2186,109655,89,2606,19112,11465,0,0,9368,232453,2413710,17,0,0,613,,,611,,,468,33649,0,4949,29023,75683,
259,2020-12-03,1882,111537,100,2706,18904,11465,0,0,10895,243348,2432614,9,0,0,622,,,620,,,-339,33310,0,4958,29474,77105,
260,2020-12-04,1667,113185,98,2804,18241,11465,0,0,8841,252189,2450855,-10,0,0,612,,,635,,,-807,32503,0,4966,29765,78454,
261,2020-12-05,1383,114568,98,2902,19092,11465,0,0,8547,260736,2469947,-18,0,0,594,,,641,,,-1850,30653,0,4981,30207,79380,
262,2020-12-06,904,115471,101,3003,9214,11465,0,0,3754,264490,2479161,6,0,0,600,,,651,,,-2360,28293,0,4986,30594,79891,
263,2020-12-07,1251,116721,89,3092,6105,11465,0,0,4421,268911,2485266,0,0,0,600,,,668,,,-1298,26995,0,5007,31293,80421,
264,2020-12-08,1382,118045,102,3194,19438,11465,0,0,10612,279523,2504704,-21,0,0,579,,,680,,,-973,26022,0,5022,32079,80944,
265,2020-12-09,1677,119720,95,3289,18014,11465,0,0,12278,291801,2522718,-1,0,0,578,,,691,,,192,26214,0,5038,33160,81522,
266,2020-12-10,1534,121253,81,3370,17326,11465,0,0,15168,306969,2540044,-7,0,0,571,,,697,,,134,26348,0,5066,34181,82006,
267,2020-12-11,1395,122648,102,3472,17101,11465,0,0,15646,322615,2557145,12,0,0,583,,,711,,,-730,25618,0,5076,34774,82798,
268,2020-12-12,1194,123842,68,3540,15683,11465,0,0,15601,338216,2572828,-6,0,0,577,,,718,,,-953,24665,0,5100,35290,83452,
269,2020-12-13,693,124534,85,3625,9432,11465,0,0,6360,344576,2582260,-25,0,0,552,,,730,,,-1319,23346,0,5109,35564,83861,
270,2020-12-14,639,125173,62,3687,7178,11465,0,0,4801,349377,2589438,6,0,0,558,,,732,,,-1306,22040,0,5126,35741,84306,
271,2020-12-15,1240,126372,98,3785,17577,11465,0,0,15360,364737,2607015,-8,0,0,550,,,755,,,-540,21500,0,5143,36203,85026,
272,2020-12-16,1190,127557,85,3870,17290,11465,0,0,16437,381174,2624305,2,0,0,552,,,768,,,-3,21497,0,5163,36669,85725,
273,2020-12-17,1155,128710,78,3948,15853,11465,0,0,17656,398830,2640158,-10,0,0,542,,,782,,,117,21614,0,5171,37197,86342,
274,2020-12-18,916,129584,96,4044,16849,11465,0,0,19235,418065,2657007,-15,0,0,527,,,927,,,-1286,20328,0,5178,37630,86776,
275,2020-12-19,901,130485,58,4102,17200,11465,0,0,15401,433466,2674207,7,0,0,534,,,797,,,-1241,19087,0,5196,38050,87239,
276,2020-12-20,588,131072,70,4172,8639,11465,0,0,6987,440453,2682846,-19,0,0,515,210,230,800,80.00,45.00,-1271,17816,0,5211,38349,87512,
277,2020-12-21,526,131597,85,4257,4966,11465,0,0,6895,447348,2687812,-10,0,0,505,210,230,812,80.00,45.00,-1120,16696,0,5229,38481,87887,
278,2020-12-22,853,132430,83,4340,16762,11465,0,0,16961,464309,2704574,-14,0,0,491,210,230,823,80.00,45.00,-539,16157,0,5248,38804,88378,
279,2020-12-23,937,133365,62,4402,15298,11465,0,0,18289,482598,2719872,4,0,0,495,,,832,,,57,16214,0,5267,39198,88900,
280,2020-12-24,873,134235,55,4457,14116,11465,0,0,17659,500257,2733988,-19,0,0,476,,,845,,,-342,15872,0,5284,39565,89386,
281,2020-12-25,617,134852,50,4507,15549,11465,0,0,14513,514770,2749537,-6,0,0,470,,,851,,,-658,15214,0,5302,39813,89737,
282,2020-12-26,262,135114,46,4553,3217,11465,0,0,2615,517385,2752754,3,0,0,473,,,852,,,-1362,13852,0,5316,39906,89892,
283,2020-12-27,342,135456,53,4606,3467,11465,0,0,2676,520061,2756221,-4,0,0,469,,,857,,,-1162,12690,0,5343,40024,90089,
284,2020-12-28,476,135931,66,4672,3309,11465,0,0,4030,524091,2759530,-2,0,0,467,,,862,,,-887,11803,0,5356,40165,90410,386
285,2020-12-29,1047,136976,58,4730,15491,11465,0,0,16438,540529,2775021,-9,0,0,458,,,877,,,-139,11664,0,5380,40566,91030,1056
286,2020-12-30,942,137918,58,4788,14433,11465,0,0,20582,561111,2789454,-15,0,0,443,,,885,,,254,11918,0,5412,40963,91543,1709
287,2020-12-31,932,138850,50,4838,13572,11465,0,0,18351,579462,2803026,-5,0,0,438,,,890,,,312,12230,0,5422,41299,92129,2313
288,2021-01-01,597,139447,43,4881,14679,11465,0,0,13960,593422,2817705,-9,0,0,429,,,893,,,-538,11692,0,5430,41491,92526,2591
289,2021-01-02,262,139709,40,4921,3156,11465,0,0,1642,595064,2820861,2,0,0,431,,,896,,,-885,10807,0,5457,41741,92511,3132
290,2021-01-03,390,140099,36,4957,4366,11465,0,0,4138,599202,2825227,-10,0,0,421,,,897,,,-719,10088,0,5463,41926,92710,3843
291,2021-01-04,427,140526,54,5011,3234,11465,0,0,5048,604250,2828461,-14,0,0,407,,,902,,,-413,9675,0,5478,42054,92994,9975
292,2021-01-05,928,141453,40,5051,11817,11465,0,0,20179,624429,2840278,-2,0,0,405,,,907,,,23,9698,0,5517,42416,93520,16233
293,2021-01-06,816,142267,48,5099,13881,11465,0,0,16405,640834,2854159,-6,0,0,399,,,912,,,234,9932,0,5547,42716,94004,20466
294,2021-01-07,510,142777,47,5146,4882,11465,0,0,3815,644649,2859041,-8,0,0,391,,,911,,,23,9955,0,5565,42934,94278,26006
295,2021-01-08,721,143494,49,5195,11857,11465,0,0,24601,669250,2870898,-5,0,0,386,,,950,,,-77,9878,0,5579,43251,94664,34787
296,2021-01-09,800,144293,32,5227,11828,11465,0,0,24855,694105,2882726,-24,0,0,362,,,954,,,-106,9772,0,5598,43583,95112,40163
297,2021-01-10,445,144738,36,5263,8464,11465,0,0,11244,705349,2891190,-9,0,0,353,,,954,,,-407,9365,0,5616,43776,95346,44080
298,2021-01-11,444,145179,39,5302,5953,11465,0,0,10717,716066,2897143,-3,0,0,350,,,962,,,-161,9204,0,5630,43957,95592,49645
299,2021-01-12,866,146020,27,5329,12556,11465,0,0,29118,745184,2909699,-13,0,0,337,,,977,,,591,9795,0,5651,44252,96117,56199
300,2021-01-13,671,146688,25,5354,11864,11465,0,0,23116,768300,2921563,3,0,0,340,,,1000,,,359,10154,0,5673,44562,96453,65003
301,2021-01-14,599,147283,33,5387,12275,11465,0,0,22764,791064,2933838,-12,0,0,328,,,1006,,,157,10311,0,5682,44815,96786,70695
302,2021-01-15,610,147860,34,5421,11568,11465,0,0,20960,812024,2945406,-9,0,0,319,,,1019,,,-447,9864,0,5709,45140,97011,75276
303,2021-01-16,510,148370,20,5441,11456,11465,0,0,18857,830881,2956862,4,0,0,323,,,1028,,,-374,9490,0,5721,45355,97294,79744
304,2021-01-17,237,148607,28,5469,6090,11465,0,0,4705,835586,2962952,-3,0,0,320,,,1030,,,-681,8809,0,5739,45466,97402,79744
305,2021-01-18,320,148925,19,5488,3712,11465,0,0,4461,840047,2966664,2,0,0,322,97,111,1031,50.07,21.53,-271,8538,0,5763,45578,97584,85223
306,2021-01-19,566,149462,30,5518,10932,11465,0,0,20667,860714,2977596,-2,0,0,320,,,1037,,,289,8827,0,5786,45808,97868,93179
307,2021-01-20,516,149973,27,5545,11743,11465,0,0,18686,879400,2989339,-20,0,0,300,100,137,1044,48.89,19.80,117,8944,0,5805,46011,98157,107335
308,2021-01-21,509,150479,25,5570,10974,11465,0,0,18481,897881,3000313,-7,0,0,293,131,126,1050,48.20,19.60,115,9059,0,5813,46236,98430,123347
309,2021-01-22,585,151041,28,5598,12579,11465,0,0,19858,917739,3012892,-5,0,0,288,102,109,1059,41.04,17.52,-323,8736,0,5822,46487,98732,140870
310,2021-01-23,605,151646,24,5622,12084,11465,0,0,18912,936651,3024976,4,0,0,292,,,1066,,,-163,8573,0,5830,46753,99063,157388
311,2021-01-24,334,151980,24,5646,5776,11465,0,0,6097,942748,3030752,-4,0,0,288,113,30,1068,46.30,20.10,-142,8431,0,5837,46929,99214,157388
312,2021-01-25,436,152412,25,5671,3307,11465,0,0,6087,948835,3034059,-2,0,0,286,115,123,1070,45.25,19.57,-273,8158,0,5863,47124,99425,177377
313,2021-01-26,842,153226,21,5692,17204,11465,0,0,19036,967871,3051263,-3,0,0,283,150,131,1080,45.25,19.33,34,8192,0,5874,47407,99945,195783
314,2021-01-27,858,154083,32,5724,20074,11465,0,0,17621,985492,3071337,-9,0,0,274,135,111,1090,43.51,19.46,415,8607,0,5893,47802,100388,213735
315,2021-01-28,716,154796,18,5742,15796,11465,0,0,18248,1003740,3087133,-6,0,0,268,135,100,1095,42.30,20.03,296,8903,0,5904,48259,100633,232070
316,2021-01-29,941,155678,22,5764,27286,11465,0,0,18095,1021835,3114419,-8,0,0,260,155,115,1099,41.74,20.17,44,8947,0,5927,48600,101151,251303
317,2021-01-30,795,156473,15,5779,12890,11465,0,0,19014,1040849,3127309,-3,0,0,257,,,1106,,,150,9097,0,5936,48939,101598,271287
318,2021-01-31,484,156957,17,5796,6656,11465,0,0,6501,1047350,3133965,-2,0,0,255,119,44,1113,41.08,22.10,-103,8994,0,5953,49216,101788,269106
319,2021-02-01,543,157495,33,5829,3709,11465,0,0,7642,1054992,3137674,-7,0,0,248,148,77,1121,40.48,23.10,-26,8968,0,5968,49417,102110,293817
320,2021-02-02,1261,158716,22,5851,16721,11465,0,0,20870,1075862,3154395,-4,0,0,244,176,171,1131,40.48,22.81,701,9669,0,5988,49885,102843,315628
321,2021-02-03,1151,159866,27,5878,15121,11465,0,0,23575,1099437,3169516,2,0,0,246,151,110,1138,39.73,22.91,921,10590,0,5999,50438,103429,338122
322,2021-02-04,1070,160935,25,5903,16331,11465,0,0,28065,1127502,3185847,3,0,0,249,193,112,1149,41.39,23.96,766,11356,0,6002,50974,103959,359723
323,2021-02-05,1195,162107,19,5922,21328,11465,0,0,24560,1152062,3207175,-3,0,0,246,232,126,1155,42.60,27.02,661,12017,0,6010,51438,104659,380136
324,2021-02-06,1113,163213,29,5951,22028,11465,0,0,24029,1176091,3229203,3,0,0,249,225,122,1161,42.99,26.03,598,12615,0,6024,51830,105359,397857
325,2021-02-07,733,163946,21,5972,13128,11465,0,0,8869,1184960,3242331,13,0,0,262,165,48,1164,45.00,27.40,226,12841,0,6037,52276,105633,397857
326,2021-02-08,638,164575,25,5997,11337,11465,0,0,6815,1191775,3253668,14,0,0,276,208,123,1169,47.27,28.04,71,12912,0,6045,52595,105935,417565
327,2021-02-09,1526,166067,20,6017,23769,11465,0,0,29246,1221021,3277437,1,0,0,277,214,194,1176,47.30,27.86,883,13795,0,6061,52913,107093,437872
328,2021-02-10,1496,167549,17,6034,22800,11465,0,0,28607,1249628,3300237,7,0,0,284,238,157,1185,48.53,28.31,1150,14945,0,6073,53600,107876,459535
329,2021-02-11,1327,168872,22,6056,23086,11465,0,0,27793,1277421,3323323,-3,0,0,281,220,164,1194,49.30,28.43,905,15850,0,6088,54146,108638,482416
330,2021-02-12,1410,170244,21,6077,23271,11465,0,0,24391,1301812,3346594,12,0,0,293,254,171,1204,50.39,29.50,571,16421,0,6086,54695,109463,506038
331,2021-02-13,1222,171466,26,6103,20864,11465,0,0,24969,1326781,3367458,7,0,0,300,248,136,1211,49.80,30.26,390,16811,0,6086,54695,110685,526369
332,2021-02-14,662,172128,23,6126,12378,11465,0,0,7316,1334097,3379836,1,0,0,301,201,43,1218,50.77,32.41,-45,16766,0,6086,54695,111347,526369
333,2021-02-15,698,172824,26,6152,9697,11465,0,0,3607,1337704,3389533,-2,0,0,299,190,133,1224,51.20,32.50,-167,16599,0,6086,54695,112043,554745
334,2021-02-16,1121,173905,29,6181,21545,11465,0,0,18901,1356605,3411078,10,0,0,309,211,141,1231,52.42,33.03,281,16880,0,6086,54695,113124,575766
335,2021-02-17,755,174659,13,6194,13643,11465,0,0,12081,1368686,3424721,4,0,0,313,181,186,1246,53.05,32.60,291,17171,0,6086,54695,113878,603667
336,2021-02-18,1400,176059,27,6221,19966,11465,0,0,17043,1385729,3444687,7,0,0,320,277,212,1256,53.29,32.29,883,18054,0,6086,54695,115278,634037
337,2021-02-19,1460,177494,28,6249,23309,11465,0,0,22344,1408073,3467996,5,0,0,325,247,185,1267,53.88,32.31,228,18282,0,6086,54695,116713,664347
338,2021-02-20,1424,178918,23,6272,20892,11465,0,0,22418,1430491,3488888,0,0,0,325,259,146,1270,55.07,33.43,289,18571,0,6086,54695,118137,693436
339,2021-02-21,884,179802,25,6297,14716,11465,0,0,8423,1438914,3503604,1,0,0,326,264,75,1267,54.52,35.63,-182,18389,0,6086,54695,119021,697245
340,2021-02-22,880,180672,24,6321,10197,11465,0,0,5413,1444327,3513801,20,0,0,346,299,176,1280,55.09,37.04,-299,18090,0,6086,54695,119891,730410
341,2021-02-23,2147,182783,22,6343,25131,11465,0,0,30412,1474739,3538932,11,0,0,357,304,216,1291,55.52,36.88,1026,19116,0,6086,54695,122002,762624
342,2021-02-24,1913,184686,28,6371,22523,11465,0,0,26692,1501431,3561455,0,0,0,357,292,265,1299,56.83,36.29,1176,20292,0,6086,54695,123905,794347
343,2021-02-25,1784,186469,39,6410,23192,11465,0,0,27055,1528486,3584647,10,0,0,367,302,231,1315,58.35,35.97,1148,21440,0,6086,54695,125688,826370
344,2021-02-26,1790,188201,29,6439,23861,11465,0,0,26473,1554959,3608508,4,0,0,371,374,202,1326,57.08,37.58,247,21687,0,6086,54695,127420,857306
345,2021-02-27,1630,189831,29,6468,23323,11465,0,0,22742,1577701,3631831,8,0,0,379,319,176,1338,60.06,38.73,148,21835,0,6086,54695,129050,885821
346,2021-02-28,1269,191100,36,6504,16718,11465,0,0,9612,1587313,3648549,12,0,0,391,273,73,1341,60.17,40.92,-56,21779,0,6086,54695,130319,885821
347,2021-03-01,1176,192270,30,6534,11846,11465,0,0,6090,1593403,3660395,15,0,0,406,307,227,1347,61.96,40.92,-211,21568,0,6086,54695,131489,921189
348,2021-03-02,2353,194582,23,6557,26693,11465,0,0,34562,1627965,3687088,16,0,0,422,426,235,1364,63.62,43.05,1093,22661,0,6086,54695,133801,957139
349,2021-03-03,2702,197279,40,6597,24435,11465,0,0,30118,1658083,3711523,9,0,0,431,393,266,1376,63.85,43.85,2018,24679,0,6086,54695,136498,991409
350,2021-03-04,2219,199496,35,6632,24368,11465,0,0,31334,1689417,3735891,18,0,0,449,403,269,1389,64.87,44.99,1512,26191,0,6086,54695,138715,1024711
351,2021-03-05,2215,201677,32,6664,26171,11465,0,0,29890,1719307,3762062,2,0,0,451,387,243,1398,64.07,45.96,1097,27288,0,6086,54695,140896,1059304
352,2021-03-06,2301,203978,41,6705,23687,11465,0,0,29422,1748729,3785749,1,0,0,452,460,209,1403,66.01,47.22,1519,28807,0,6086,54695,143197,1091749
353,2021-03-07,1142,205120,53,6758,15311,11465,0,0,9187,1757916,3801060,14,0,0,466,340,122,1408,66.54,49.30,-284,28523,0,6086,54695,144339,1091749
354,2021-03-08,1165,206281,39,6797,12030,11465,0,0,6995,1764911,3813090,11,0,0,477,402,230,1416,66.45,50.76,-285,28238,0,6086,54695,145500,1126060
355,2021-03-09,3215,209462,46,6843,22870,11465,0,0,37168,1802079,3835960,7,0,0,484,476,366,1427,67.27,49.82,1734,29972,0,6086,54695,148681,1158386
356,2021-03-10,2633,212091,43,6886,19224,11465,0,0,32558,1834637,3855184,-5,0,0,479,501,301,1445,69.21,51.83,1727,31699,0,6086,54695,151310,1190723
357,2021-03-11,2570,214661,51,6937,18754,11465,0,0,31324,1865961,3873938,27,0,0,506,479,337,1457,69.40,50.73,1673,33372,0,6086,54695,153880,1222393
358,2021-03-12,2405,217018,49,6986,17733,11465,0,0,29824,1895785,3891671,15,0,0,521,456,427,1472,69.90,49.31,219,33591,0,6086,54695,156237,1254087
359,2021-03-13,2512,219521,52,7038,18795,11465,0,0,31544,1927329,3910466,24,0,0,545,424,274,2504,71.68,49.86,576,34167,0,6086,54695,158740,1283472
360,2021-03-14,1626,221147,53,7091,8579,11465,0,0,10244,1937573,3919045,19,0,0,564,493,152,1489,73.29,52.90,-171,33996,0,6086,54695,160366,1283472
361,2021-03-15,1134,222281,46,7137,6120,11465,0,0,5594,1943167,3925165,0,0,0,564,457,166,1494,76.18,56.55,-615,33381,0,6086,54695,161500,1285437
362,2021-03-16,1533,223789,59,7196,6244,11465,0,0,6215,1949382,3931409,41,0,0,605,459,328,1505,77.76,56.64,-152,33229,0,6086,54695,163008,1316554
363,2021-03-17,3465,227247,56,7252,24721,11465,0,0,38933,1988315,3956130,25,0,0,630,560,480,1516,76.97,56.28,2169,35398,0,6086,54695,166466,1345735
364,2021-03-18,3073,230317,45,7297,20235,11465,0,0,33371,2021686,3976365,15,0,0,645,525,497,1537,78.99,54.98,1885,37283,0,6086,54695,169536,1375828
365,2021-03-19,2785,233079,64,7361,18947,11465,0,0,33903,2055589,3995312,4,0,0,649,518,472,1555,80.00,54.52,409,37692,0,6086,54695,172298,1407064
366,2021-03-20,2535,235611,60,7421,17681,11465,0,0,33377,2088966,4012993,23,0,0,672,513,337,1572,80.05,55.40,-185,37507,0,6086,54695,174830,1436491
367,2021-03-21,1514,237125,41,7462,7593,11465,0,0,10465,2099431,4020586,2,0,0,674,425,145,1577,80.33,57.99,-709,36798,0,6086,54695,176344,1436491
368,2021-03-22,1707,238830,69,7531,6915,11465,0,0,7159,2106590,4027501,7,0,0,681,576,301,1592,81.15,59.41,-513,36285,0,6086,54695,178049,1469020
369,2021-03-23,3586,242347,51,7582,24091,11465,0,0,40330,2146920,4051592,18,0,0,699,543,452,1613,80.60,58.20,1206,37491,0,6086,54695,181566,1503487
370,2021-03-24,3062,245405,67,7649,19904,11465,0,0,35938,2182858,4071496,0,0,0,699,522,433,1632,80.12,57.21,1902,39393,0,6086,54695,184624,1536957
371,2021-03-25,2588,247992,52,7701,16483,11465,0,0,36410,2219268,4087979,7,0,0,706,511,360,1643,83.24,56.62,1413,40806,0,6086,54695,187211,1537104
372,2021-03-26,1496,249458,53,7754,5911,11465,0,0,5631,2224899,4093890,1,0,0,707,420,403,1648,83.30,55.07,-1722,39084,0,6086,54695,188677,1572726
373,2021-03-27,3133,252590,72,7826,19538,11465,0,0,38620,2263519,4113428,21,0,0,728,486,359,1656,83.93,53.71,474,39558,0,6086,54695,191809,1604238
374,2021-03-28,1449,254031,54,7880,8426,11465,0,0,12852,2276371,4121854,7,0,0,735,480,190,1664,83.98,56.25,-1132,38426,0,6086,54695,193250,1604238
375,2021-03-29,1724,255755,65,7945,6724,11465,0,0,8883,2285254,4128578,3,0,0,738,464,302,1677,82.15,56.28,-649,37777,0,6086,54695,194974,1635676
376,2021-03-30,4340,260077,72,8017,23158,11465,0,0,42821,2328075,4151736,3,0,0,741,479,531,1688,84.35,54.41,1799,39576,0,6086,54695,199296,1668956
377,2021-03-31,3616,263689,76,8093,19477,11465,0,0,36458,2364533,4171213,-2,0,0,739,561,391,1701,85.06,55.58,1963,41539,0,6086,54695,202908,1699807
378,2021-04-01,3491,267172,67,8160,17628,11465,0,0,35830,2400363,4188841,16,0,0,755,562,400,1717,85.29,56.70,2328,43867,0,6086,54695,206391,1739051
379,2021-04-02,3080,270230,72,8232,19049,11465,0,0,37854,2438217,4207890,-2,0,0,753,449,429,1733,85.60,54.87,1537,45404,0,6086,54695,209449,1777502
380,2021-04-03,3232,273459,70,8302,19427,11465,0,0,42694,2480911,4227317,2,0,0,755,562,401,1746,84.62,55.57,-243,45161,0,6086,54695,212678,1830362
381,2021-04-04,1955,275414,78,8380,8375,11465,0,0,14919,2495830,4235692,-6,0,0,749,438,160,1761,84.71,57.88,-1148,44013,0,6086,54695,214633,1830362
382,2021-04-05,1866,277277,73,8453,6652,11465,0,0,9680,2505510,4242344,10,0,0,759,526,382,1771,84.43,58.77,-908,43105,0,6086,54695,216496,1886370
383,2021-04-06,4309,281570,79,8532,24543,11465,0,0,50639,2556149,4266887,-8,0,0,751,524,568,1788,82.91,56.92,1742,44847,0,6086,54695,220789,1946339
384,2021-04-07,3445,285015,75,8607,20419,11465,0,0,34760,2590909,4287306,-2,0,0,749,595,482,1805,83.82,57.43,1897,46744,0,6086,54695,224234,2003644
385,2021-04-08,3228,288230,73,8680,18058,11465,0,0,40398,2631307,4305364,27,0,0,776,559,469,1825,84.96,57.39,1506,48250,0,6086,54695,227449,2058750
386,2021-04-09,2747,290964,78,8758,18390,11465,0,0,38980,2670287,4323754,14,0,0,790,504,459,1839,84.14,56.85,-810,47440,0,6086,54695,230183,2114222
387,2021-04-10,2801,293763,75,8833,18466,11465,0,0,47405,2717692,4342220,-9,0,0,781,460,460,1853,85.36,55.45,-267,47173,0,6086,54695,232982,2169353
388,2021-04-11,1718,295480,52,8885,6858,11465,0,0,22029,2739721,4349078,-1,0,0,780,539,167,1859,85.32,58.95,-870,46303,0,6086,54695,234699,2169353
389,2021-04-12,1606,297086,76,8961,6988,11465,0,0,13684,2753405,4356066,1,0,0,781,458,399,1870,85.02,58.83,117,46420,0,6086,54695,236305,2225878
390,2021-04-13,4033,301103,93,9054,24958,11465,0,0,51112,2804517,4381024,21,0,0,802,562,632,1901,85.53,56.85,864,47284,0,6086,54695,240322,2280934
391,2021-04-14,3089,304184,81,9135,18469,11465,254157,254157,45241,2849758,4399493,7,0,0,809,526,482,1912,87.32,55.84,1613,48897,0,6086,54695,243403,2334557
392,2021-04-15,3833,308006,104,9239,20814,11465,0,254157,44184,2893942,4420307,10,0,0,819,547,436,1925,86.66,57.16,2059,50956,0,6086,54695,247225,2387148
393,2021-04-16,3067,311033,91,9330,19874,11465,0,254157,45335,2939277,4440181,5,0,0,824,507,487,1927,87.98,56.20,-1314,49642,0,6086,54695,250252,2440210
394,2021-04-17,2411,313444,67,9397,17532,11465,0,254157,46649,2985926,4457713,13,0,0,837,495,389,1936,88.58,56.39,-1192,48450,0,6086,54695,252663,2491857
395,2021-04-18,1829,315273,65,9462,7690,11465,0,254157,17479,3003405,4465403,4,0,0,841,468,229,1941,88.48,58.40,-1652,46798,0,6086,54695,254492,2491857
396,2021-04-19,1607,316879,78,9540,6597,11465,0,254157,14251,3017656,4472000,6,0,0,847,406,348,1943,89.80,58.13,-1458,45340,0,6086,54695,256098,2546154
397,2021-04-20,3789,320629,87,9627,23623,11465,0,254157,54805,3072461,4495623,0,0,0,847,556,564,1963,88.98,57.21,504,45844,0,6086,54695,259848,2600998
398,2021-04-21,3015,323639,86,9713,17452,11465,580662,834819,43871,3116332,4513075,-16,0,0,831,468,505,1976,87.97,55.84,1047,46891,0,6086,54695,262858,2652448
399,2021-04-22,2759,326395,75,9788,19779,11465,0,834819,43269,3159601,4532854,-9,0,0,822,456,447,1986,86.34,55.27,891,47782,0,6086,54695,265614,2708780
400,2021-04-23,2754,329134,76,9864,18285,11465,0,834819,48077,3207678,4551139,-3,0,0,819,472,485,2003,85.17,54.77,-1551,46231,0,6086,54695,268353,2765367
401,2021-04-24,2597,331730,86,9950,17923,11465,0,834819,48228,3255906,4569062,-22,0,0,797,481,485,2019,85.17,54.77,-860,45371,0,6086,54695,270949,2821625
402,2021-04-25,1400,333129,57,10007,8547,11465,0,834819,14559,3270465,4577609,19,0,0,816,451,184,2032,86.02,57.27,-1800,43571,0,6086,54695,272348,2821625
403,2021-04-26,1317,334436,80,10087,6044,11465,0,834819,16329,3286794,4583653,-5,0,0,811,367,371,2050,85.85,56.06,-1429,42142,0,6086,54695,273655,2883199
404,2021-04-27,3313,337723,92,10179,24488,11465,0,834819,52366,3339160,4608141,2,0,0,813,530,598,2070,85.71,54.29,471,42613,0,6086,54695,276942,2945058
405,2021-04-28,2781,340493,63,10242,18765,11465,908210,1743029,42526,3381686,4626906,-8,0,0,805,484,496,2087,87.08,53.16,1042,43655,0,6086,54695,279712,3009488
406,2021-04-29,2435,342908,73,10315,18309,11465,84357,1827386,52790,3434476,4645215,12,0,0,817,419,541,2104,86.31,50.91,812,44467,0,6086,54695,282127,3075698
407,2021-04-30,2155,345033,66,10381,15681,11465,64962,1892348,40788,3475264,4660896,-15,0,0,802,491,430,2121,84.72,50.12,-1865,42602,0,6086,54695,284252,3097693
408,2021-05-01,1391,346422,72,10453,7379,11465,47770,1940118,22073,3497337,4668275,9,0,0,811,,,2124,,,-1683,40919,0,6086,54695,285641,3115339
409,2021-05-02,0,346422,0,10453,0,11465,0,1940118,0,3497337,4668275,0,0,0,811,,,,,,-3718,37201,0,6086,54695,285641,3115339
410,2021-05-03,2146,348568,134,10587,9948,11465,38507,1978625,13889,3511226,4678223,-14,0,0,797,387,200,2146,84.83,52.40,-924,36277,0,6086,54695,287787,3136791
411,2021-05-04,1387,349936,81,10668,7058,11465,155011,2133636,14453,3525679,4685281,-14,0,0,783,369,229,2146,84.14,53.14,-1057,35220,0,6086,54695,289155,3201212
412,2021-05-05,2093,352027,96,10764,9119,11465,152284,2285920,24839,3550518,4694400,-18,0,0,765,370,412,2148,81.31,52.02,231,35451,0,6086,54695,291246,3309765
413,2021-05-06,3421,355445,83,10847,23804,11465,105773,2391693,56213,3606731,4718204,-11,0,0,754,392,526,2153,80.34,49.77,1807,37258,0,6086,54695,294664,3424441
414,2021-05-07,2691,358116,63,10910,17857,11465,757299,3148992,43948,3650679,4736061,-5,0,0,749,371,513,2165,79.33,47.38,-1055,36203,0,6086,54695,297335,3535148
415,2021-05-08,2461,360577,68,10978,17884,11465,75262,3224254,41065,3691744,4753945,-12,0,0,737,370,416,2174,78.64,46.55,-531,35672,0,6086,54695,299796,3647616
416,2021-05-09,1428,362004,51,11029,7356,11465,56290,3280544,15513,3707257,4761301,-9,0,0,728,383,178,2183,77.83,48.48,-1305,34367,0,6086,54695,301223,3647689
417,2021-05-10,1904,363904,60,11089,7169,11465,977390,4257934,20958,3728215,4768470,4,0,0,732,294,361,2199,77.55,47.14,-823,33544,0,6086,54695,303123,3760640
418,2021-05-11,3197,367076,52,11141,26117,11465,227879,4485813,59453,3787668,4794587,0,0,0,732,318,526,2216,77.87,44.07,610,34154,0,6086,54695,306295,3868356
419,2021-05-12,2489,369554,70,11211,18499,11465,153614,4639427,44608,3832276,4813086,-25,0,0,707,293,456,2226,75.74,41.66,1066,35220,0,6086,54695,308773,3973336
420,2021-05-13,2167,371693,55,11266,17397,11465,99279,4738706,44918,3877194,4830483,-24,0,0,683,381,376,2238,74.01,41.27,857,36077,0,6086,54695,310912,4079168
421,2021-05-14,2188,373881,56,11322,18700,11465,145272,4883978,46433,3923627,4849183,-6,0,0,677,302,444,2255,72.41,39.27,-1063,35014,0,6086,54695,313100,4185347
422,2021-05-15,1957,375831,43,11365,16573,11465,277244,5161222,43354,3966981,4865756,-16,0,0,661,287,301,2272,72.21,38.73,-800,34214,0,6086,54695,315050,4292541
423,2021-05-16,1262,377090,50,11415,7761,11465,170535,5331757,15682,3982663,4873517,-5,0,0,656,318,160,2280,71.60,40.31,-1133,33081,0,6086,54695,316309,4292541
424,2021-05-17,1402,378485,56,11471,5352,11465,121480,5453237,17976,4000639,4878869,-9,0,0,647,334,298,2287,70.97,40.40,-720,32361,0,6086,54695,317704,4405618
425,2021-05-18,2812,381266,63,11534,22211,11465,1220704,6673941,48306,4048945,4901080,-8,0,0,639,305,441,2298,70.06,36.19,1401,33762,0,6086,54695,320485,4513979
426,2021-05-19,2293,383558,53,11587,16641,11465,1982747,8656688,36542,4085487,4917721,3,0,0,642,295,328,2312,70.66,38.37,2239,36001,0,6086,54695,322777,4615746
427,2021-05-20,1918,385444,54,11641,16349,11465,99673,8756361,40174,4125661,4934070,-16,0,0,626,260,348,2314,68.32,37.05,-180,35821,0,6086,54695,324663,4716739
428,2021-05-21,2020,387426,56,11697,15979,11465,316216,9072577,36715,4162376,4950049,-9,0,0,617,267,379,2327,66.21,35.25,639,36460,0,6086,54695,326645,4814981
429,2021-05-22,1505,388929,37,11734,15658,11465,102889,9175466,39483,4201859,4965707,-31,0,0,586,229,264,2342,65.51,34.95,-529,35931,0,6086,54695,328148,4913334
430,2021-05-23,877,389804,38,11772,6500,11465,57416,9232882,13576,4215435,4972207,-17,0,0,569,210,131,2348,65.53,35.76,-2498,33433,0,6086,54695,329023,4913334
431,2021-05-24,1381,391181,50,11822,4953,11465,172321,9405203,16222,4231657,4977160,-6,0,0,563,194,266,2353,62.41,34.60,-1281,32152,0,6086,54695,330400,5012666
432,2021-05-25,2433,393583,50,11872,21761,11465,506771,9911974,48341,4279998,4998921,-7,0,0,556,250,402,2368,62.42,32.65,-41,32111,0,6086,54695,332802,5107830
433,2021-05-26,1517,395094,44,11916,15869,11465,1779203,11691177,35123,4315121,5014790,-9,0,0,547,206,303,2391,63.27,30.70,91,32202,0,6086,54695,334313,5206825
434,2021-05-27,1905,396970,39,11955,14472,11465,233979,11925156,33965,4349086,5029262,-7,0,0,540,231,256,2401,63.24,30.32,-3,32199,0,6086,54695,336189,5305355
435,2021-05-28,1585,398898,40,11995,14609,11465,341511,12266667,34380,4383466,5043871,-19,0,0,521,203,301,2411,61.95,28.97,-1232,30967,0,6086,54695,338117,5402105
436,2021-05-29,1497,400395,29,12024,14424,11465,188046,12454713,36043,4419509,5058295,-11,0,0,510,198,215,2417,62.29,28.46,-940,30027,0,6086,54695,339614,5498042
437,2021-05-30,907,401301,30,12054,6318,11465,61142,12515855,13457,4432966,5064613,-13,0,0,497,151,82,2420,60.84,29.32,-1208,28819,0,6086,54695,340520,5498042
438,2021-05-31,1007,402306,41,12095,5289,11465,368062,12883917,17697,4450663,5069902,-16,0,0,481,173,218,2429,60.87,28.37,-1168,27651,0,6086,54695,341525,5597624
439,2021-06-01,1886,404163,27,12122,19537,11465,2100903,14984820,42107,4492770,5089439,1,0,0,482,198,304,2442,61.46,27.17,-77,27574,0,6086,54695,343382,5691818
440,2021-06-02,1381,405542,23,12145,14596,11465,289535,15274355,30588,4523358,5104035,4,0,0,486,145,275,2462,60.69,26.05,147,27721,0,6086,54695,344761,5791280
441,2021-06-03,1239,406751,39,12184,14647,11465,131978,15406333,31604,4554962,5118682,-10,0,0,476,151,265,2473,59.18,24.90,-169,27552,0,6086,54695,345970,5888281
442,2021-06-04,1112,407857,34,12218,14050,11465,85148,15491481,33758,4588720,5132732,-31,0,0,445,149,243,2491,56.71,24.16,-1646,25906,0,6086,54695,347076,5986480
443,2021-06-05,932,408789,35,12253,15151,11465,339010,15830491,34657,4623377,5147883,-29,0,0,416,166,136,2498,57.99,25.35,-1342,24564,0,6086,54695,348008,6084963
444,2021-06-06,580,409368,24,12277,6773,11465,61527,15892018,13732,4637109,5154656,-18,0,0,398,129,70,2505,55.93,26.11,-1277,23287,0,6086,54695,348587,6156375
445,2021-06-07,808,410166,24,12301,5236,11465,229386,16121404,15467,4652576,5159892,-6,0,0,392,127,212,2510,54.65,24.87,-1152,22135,0,6086,54695,349385,6258951
446,2021-06-08,1339,411534,30,12331,18395,11465,1756319,17877723,37517,4690093,5178287,-11,0,0,381,106,232,2520,54.07,22.70,-128,22007,0,6086,54695,350753,6361417
447,2021-06-09,890,412420,15,12346,13926,11465,518028,18395751,28056,4718149,5192213,0,0,0,381,102,182,2532,54.95,22.08,34,22041,0,6086,54695,351639,6463465
448,2021-06-10,781,413170,24,12370,13242,11465,277539,18673290,28612,4746761,5205455,-5,0,0,376,119,167,2539,57.08,21.84,-601,21440,0,6086,54695,352389,6564056
449,2021-06-11,791,413954,11,12381,13650,11465,140183,18813473,28453,4775214,5219105,-1,0,0,375,116,192,2549,56.83,20.85,-1579,19861,0,6086,54695,353173,6665626
450,2021-06-12,591,414636,21,12405,14208,11465,207714,19021187,30567,4805781,5233313,-15,0,0,360,103,102,2560,58.45,21.54,-809,19052,0,6086,54695,353855,6770033
451,2021-06-13,297,414933,17,12422,5953,11465,120566,19141753,14561,4820342,5239266,-2,0,0,358,66,56,2562,58.60,21.63,-1557,17495,0,6086,54695,354152,6835783
452,2021-06-14,472,415401,18,12443,4335,11465,145649,19287402,15067,4835409,5243601,-5,0,0,353,75,132,2563,55.95,20.77,-1441,16054,0,6086,54695,354620,6938959
453,2021-06-15,835,416195,22,12465,16393,11465,992943,20280345,34187,4869596,5259994,-10,0,0,343,81,174,2573,52.98,19.25,-696,15358,0,6086,54695,355414,7041432
454,2021-06-16,549,416741,13,12478,12740,11465,1145119,21425464,25985,4895581,5272734,-13,0,0,330,61,129,2589,51.99,18.25,-343,15015,0,6086,54695,355960,7142822
455,2021-06-17,519,417253,16,12494,12520,11465,127021,21552485,26791,4922372,5285254,-9,0,0,321,63,127,2593,51.69,17.00,-468,14547,0,6086,54695,356472,7244517
456,2021-06-18,469,417706,20,12514,12630,11465,128676,21681161,28039,4950411,5297884,-14,0,0,307,63,144,2602,49.70,15.60,-1397,13150,0,6086,54695,356925,7345346
457,2021-06-19,394,418095,20,12534,12108,11465,231030,21912191,28638,4979049,5309992,-6,0,0,301,66,102,2609,48.00,15.11,-987,12163,0,6086,54695,357314,7446861
458,2021-06-20,248,418342,14,12548,4887,11465,68386,21980577,15129,4994178,5314879,-5,0,0,296,48,47,2611,47.60,14.93,-937,11226,0,6086,54695,357561,7508584
459,2021-06-21,209,418548,17,12565,3947,11465,0,21980577,11501,5005679,5318826,-13,0,0,283,59,40,2615,46.20,15.13,-883,10343,0,6086,54695,357767,7510968
460,2021-06-22,406,418943,16,12581,7246,11465,473173,22453750,15113,5020792,5326072,-6,0,0,277,50,88,2619,45.35,14.30,-518,9825,0,6086,54695,358162,7616421
461,2021-06-23,520,419455,14,12595,15582,11465,490829,22944579,30137,5050929,5341654,-6,0,0,271,65,94,2628,43.35,13.68,-57,9768,0,6086,54695,358674,7722093
462,2021-06-24,489,419909,15,12613,12658,11465,1298702,24243281,25634,5076563,5354312,-15,0,0,256,53,94,2639,40.79,12.79,-338,9430,0,6086,54695,359128,7822697
463,2021-06-25,395,420295,21,12634,12592,11465,62388,24305669,24715,5101278,5366904,-17,0,0,239,46,96,2649,40.19,11.87,-973,8457,0,6086,54695,359514,7925253
464,2021-06-26,375,420670,12,12646,10801,11465,93151,24398820,26152,5127430,5377705,-1,0,0,238,38,69,2657,38.89,11.12,-508,7949,0,6086,54695,359889,8028343
465,2021-06-27,236,420905,18,12664,5711,11465,0,24398820,18104,5145534,5383416,-7,0,0,231,39,24,2656,39.89,11.26,-509,7440,0,6086,54695,360124,8098959
466,2021-06-28,362,421266,8,12682,4514,11465,444930,24843750,14948,5160482,5387930,-16,0,0,215,33,62,2659,37.09,10.92,-430,7010,0,6086,54695,360485,8202338
467,2021-06-29,605,421829,13,12695,14223,11465,548376,25392126,31328,5191810,5402153,-11,0,0,204,37,69,2668,35.99,9.46,-108,6902,0,6086,54695,361048,8299173
468,2021-06-30,633,422456,11,12706,11946,11465,486750,25878876,26710,5218520,5414099,-8,0,0,196,38,64,2684,34.80,10.07,336,7238,0,6086,54695,361675,8391535
469,2021-07-01,761,423185,4,12710,12349,11465,40942,25919818,29038,5247558,5426448,-7,0,0,189,33,70,2689,35.45,9.66,278,7516,0,6086,54695,362404,8475823
470,2021-07-02,771,424165,10,12722,12584,11465,83279,26003097,27556,5275114,5439032,-3,0,0,186,45,63,2689,35.66,9.24,196,7712,0,6086,54695,363384,8559280
471,2021-07-03,1001,425347,9,12731,11358,11465,103562,26106659,32078,5307192,5450390,-9,0,0,177,30,44,2698,34.35,9.00,640,8352,0,6086,54695,364566,8641748
472,2021-07-04,619,425964,6,12737,5737,11465,74406,26181065,24193,5331385,5456127,0,0,0,177,59,15,2700,33.59,9.89,115,8467,0,6086,54695,365183,8710475
473,2021-07-05,801,426963,6,12743,4841,11465,104213,26285278,21608,5352993,5460968,-4,0,0,173,48,40,2702,34.10,10.11,560,9027,0,6086,54695,366182,8802118
474,2021-07-06,1797,429144,8,12754,15656,11465,629922,26915200,50808,5403801,5476624,-5,0,0,168,59,117,2709,31.25,9.10,1801,10828,0,6086,54695,368363,8884422
475,2021-07-07,1820,430960,9,12763,13578,11465,355549,27270749,46325,5450126,5490202,-9,0,0,159,68,60,2713,28.65,9.32,1574,12402,0,6086,54695,370179,8966023
476,2021-07-08,2107,433021,10,12773,13433,11465,125239,27395988,51578,5501704,5503635,-6,0,0,153,59,56,2720,27.45,9.42,1862,14264,0,6086,54695,372240,9050766
477,2021-07-09,1997,435018,12,12785,13456,11465,80600,27476588,55266,5556970,5517091,-12,0,0,141,68,53,2728,25.84,9.75,1606,15870,0,6086,54695,374237,9138465
478,2021-07-10,2327,437345,2,12787,14075,11465,78884,27555472,64311,5621281,5531166,1,0,0,142,65,50,2735,26.53,9.94,1827,17697,0,6086,54695,376564,9228699
479,2021-07-11,1465,438809,5,12792,7414,11465,57760,27613232,37734,5659015,5538580,0,0,0,142,85,22,2736,30.14,11.18,1023,18720,0,6086,54695,378028,9233521
480,2021-07-12,2065,440872,10,12802,6008,11465,53323,27666555,30782,5689797,5544588,-3,0,0,139,112,81,2736,25.25,12.15,1688,20408,0,6086,54695,380091,9325449
481,2021-07-13,3109,444783,4,12806,18798,11465,523329,28189884,66498,5756295,5563386,-6,0,0,133,100,74,2739,25.65,12.64,3544,23952,0,6086,54695,384002,9409245
482,2021-07-14,2938,447718,7,12813,15007,11465,128310,28318194,57561,5813856,5578393,2,0,0,135,112,87,2739,24.84,13.19,2711,26663,0,6086,54695,386937,9485402
483,2021-07-15,2794,450512,6,12819,15413,11465,177881,28496075,65871,5879727,5593806,-3,0,0,132,101,75,2740,26.07,13.51,2445,29108,0,6086,54695,389731,9560592
484,2021-07-16,2691,453200,14,12833,15592,11465,7808,28503883,72195,5951922,5609398,-9,0,0,123,122,77,2751,25.45,14.40,2124,31232,0,6086,54695,392419,9637701
485,2021-07-17,2562,455754,7,12840,16053,11465,71399,28575282,75686,6027608,5625451,1,0,0,124,132,56,2752,25.92,16.10,1931,33163,0,6086,54695,394973,9717834
486,2021-07-18,1558,457312,10,12850,9720,11465,58555,28633837,45853,6073461,5635171,-1,0,0,123,141,44,2757,26.39,18.05,823,33986,0,6086,54695,396531,9723233
487,2021-07-19,1834,459146,8,12858,5840,11465,63476,28697313,32707,6106168,5641011,0,0,0,123,136,91,2760,28.07,19.11,858,34844,0,6086,54695,398365,9807851
488,2021-07-20,3565,463473,9,12867,18760,11465,446033,29143346,70761,6176929,5659771,-2,0,0,121,161,95,2765,27.41,20.50,3145,37989,0,6086,54695,402692,9880514
489,2021-07-21,2972,466441,3,12870,14285,11465,118012,29261358,61293,6238222,5674056,4,0,0,125,173,102,2770,27.85,22.09,2354,40343,0,6086,54695,405660,9950017
490,2021-07-22,2604,469042,5,12875,15328,11465,97277,29358635,69296,6307518,5689384,1,0,0,126,145,103,2774,29.42,22.97,1603,41946,0,6086,54695,408261,10025958
491,2021-07-23,2854,471894,7,12882,15656,11465,64849,29423484,72664,6380182,5705040,4,0,0,130,178,115,2778,29.87,24.06,675,42621,0,6086,54695,411113,10093195
492,2021-07-24,2472,474366,8,12890,14789,11465,61026,29484510,80535,6460717,5719829,3,0,0,133,164,90,2785,30.53,25.59,657,43278,0,6086,54695,413585,10160738
493,2021-07-25,1553,475919,8,12898,7908,11465,73517,29558027,54015,6514732,5727737,1,0,0,134,158,63,2788,31.70,27.44,-506,42772,0,6086,54695,415138,10162629
494,2021-07-26,2070,477975,5,12903,5457,11465,30483,29588510,39536,6554268,5733194,13,0,0,147,153,108,2791,34.08,27.64,66,42838,0,6086,54695,417194,10237691
495,2021-07-27,3593,482145,8,12911,17589,11465,235467,29823977,80075,6634343,5750783,-5,0,0,142,196,177,2794,35.20,27.67,1837,44675,0,6086,54695,421364,10304614
496,2021-07-28,2874,485015,15,12926,13741,11465,260830,30084807,72382,6706725,5764524,2,0,0,144,173,158,2799,37.67,26.98,1396,46071,0,6086,54695,424234,10362660
497,2021-07-29,2696,487709,9,12935,15161,11465,94019,30178826,86873,6793598,5779685,13,0,0,157,207,137,2802,38.12,28.22,632,46703,0,6086,54695,426928,10417610
498,2021-07-30,2845,490552,12,12948,15285,11465,59491,30238317,103648,6897246,5794970,8,0,0,165,151,139,2806,39.69,28.02,-1077,45626,0,6086,54695,429771,10475917
499,2021-07-31,2760,493304,17,12965,15287,11465,50894,30289211,96844,6994090,5810257,7,0,0,172,163,111,2808,41.71,28.99,-193,45433,0,6086,54695,432523,10536457
500,2021-08-01,1605,494907,10,12975,7852,11465,56995,30346206,60524,7054614,5818109,4,0,0,176,167,56,2808,43.21,30.76,-1195,44238,0,6086,54695,434126,10538744
501,2021-08-02,2156,497061,8,12983,5628,11465,28935,30375141,43192,7097806,5823737,12,0,0,188,142,117,2815,46.61,30.81,-528,43710,0,6086,54695,436280,10588397
502,2021-08-03,3428,501030,14,12997,17844,11465,212572,30587713,85857,7183663,5841581,3,0,0,191,204,193,2815,44.16,30.72,1408,45118,0,6086,54695,440249,10634825
503,2021-08-04,2856,503885,16,13013,13698,11465,252527,30840240,74141,7257804,5855279,1,0,0,192,193,172,2820,43.95,30.70,1291,46409,0,6086,54695,443104,10676924
504,2021-08-05,2800,506672,12,13026,13588,11465,87943,30928183,91937,7349741,5868867,0,0,0,192,207,151,2829,45.01,31.54,948,47357,0,6086,54695,445891,10718787
505,2021-08-06,2925,509596,21,13048,13946,11465,48310,30976493,107146,7456887,5882813,-1,0,0,191,209,162,2836,44.32,31.97,-1416,45941,0,6086,54695,448815,10761438
506,2021-08-07,2768,512342,10,13058,14731,11465,41116,31017609,84195,7541082,5897544,7,0,0,198,209,151,2838,45.01,31.54,-229,45712,0,6086,54695,451561,10806193
507,2021-08-08,1852,514192,17,13075,7942,11465,43326,31060935,54185,7595267,5905486,6,0,0,204,212,72,2842,51.67,35.13,-763,44949,0,6086,54695,453411,10807733
508,2021-08-09,2595,516785,20,13097,6061,11465,16215,31077150,38714,7633981,5911547,3,0,0,207,211,166,2842,48.85,35.64,-274,44675,0,6086,54695,456004,10843911
509,2021-08-10,4181,521399,19,13118,17878,11465,170691,31247841,84397,7718378,5929425,12,0,0,219,246,200,2848,50.10,35.02,2129,46804,0,6086,54695,460618,10875211
510,2021-08-11,3475,524871,19,13138,13831,11465,109916,31357757,74238,7792616,5943256,7,0,0,226,200,213,2854,52.42,33.66,1907,48711,0,6086,54695,464090,10906296
511,2021-08-12,3605,528474,20,13158,12969,11465,6352,31364109,88692,7881308,5956225,14,0,0,240,255,189,2863,54.13,34.39,1532,50243,0,6086,54695,467693,10936531
512,2021-08-13,3493,531967,24,13182,13120,11465,105898,31470007,104572,7985880,5969345,-5,0,0,235,285,191,2868,53.71,35.86,-693,49550,0,6086,54695,471186,10965338
513,2021-08-14,3270,535237,24,13206,13852,11465,36053,31506060,84761,8070641,5983197,1,0,0,236,211,166,2873,54.96,36.20,391,49941,0,6086,54695,474456,10988409
514,2021-08-15,1888,537125,17,13223,7584,11465,24624,31530684,51688,8122329,5990781,5,0,0,241,224,75,2877,56.31,38.96,-814,49127,0,6086,54695,476344,10988838
515,2021-08-16,2218,539337,13,13237,5376,11465,29657,31560341,32941,8155270,5996157,9,0,0,250,218,150,2882,56.50,39.79,-632,48495,0,6086,54695,478556,11018447
516,2021-08-17,4206,543749,16,13253,19904,11465,142810,31703151,86235,8241505,6016061,8,0,0,258,290,219,2885,60.77,40.37,1661,50156,0,6086,54695,482968,11047575
517,2021-08-18,3442,547186,25,13278,16014,11465,165058,31868209,75885,8317390,6032075,24,0,0,282,276,188,2889,63.06,41.37,1819,51975,0,6086,54695,486405,11076656
518,2021-08-19,3273,550459,20,13298,15175,11465,64068,31932277,87123,8404513,6047250,4,0,0,286,267,211,2896,66.94,41.60,1107,53082,0,6086,54695,489678,11101460
519,2021-08-20,3625,554055,30,13328,15531,11465,37512,31969789,101317,8505830,6062781,10,0,0,296,280,254,2904,65.34,41.25,-389,52693,0,6086,54695,493274,11128403
520,2021-08-21,3191,557239,23,13351,15007,11465,32222,32002011,84164,8589994,6077788,21,0,0,317,229,143,2913,69.09,42.11,322,53015,0,6086,54695,496458,11153817
521,2021-08-22,1948,559186,33,13384,8744,11465,23174,32025185,53674,8643668,6086532,1,0,0,318,267,97,2917,68.75,45.04,-860,52155,0,6086,54695,498405,11154395
522,2021-08-23,2628,561812,34,13422,6292,11465,31488,32056673,41043,8684711,6092824,1,0,0,319,293,180,2916,69.96,46.44,-314,51841,0,6086,54695,501031,11186043
523,2021-08-24,4608,566812,32,13466,23867,11465,169756,32226429,98014,8782725,6116691,7,0,0,326,259,272,2926,69.44,44.85,2220,54061,0,6086,54695,506031,11215341
524,2021-08-25,3273,570077,42,13509,17144,11465,176852,32403281,76844,8859569,6133835,6,0,0,332,265,202,2936,70.58,45.27,1389,55450,0,6086,54695,509296,11247943
525,2021-08-26,3538,573605,28,13539,16039,11465,62133,32465414,87221,8946790,6149874,4,0,0,336,248,239,2943,70.24,44.69,927,56377,0,6086,54695,512824,11278583
526,2021-08-27,3076,576672,22,13561,15196,11465,34063,32499477,97733,9044523,6165070,1,0,0,337,279,276,2951,65.99,43.33,-1548,54829,0,6086,54695,515891,11311667
527,2021-08-28,3064,579734,35,13599,16108,11465,27506,32526983,79642,9124165,6181178,-4,0,0,333,282,204,2960,65.26,44.29,-428,54401,0,6086,54695,518953,11342438
528,2021-08-29,1582,581315,37,13636,8974,11465,20241,32547224,47541,9171706,6190152,1,0,0,334,214,122,2962,66.00,45.10,-2039,52362,0,6086,54695,520534,11343445
529,2021-08-30,2343,583658,19,13656,6700,11465,28669,32575893,42902,9214608,6196852,4,29,309,338,239,192,2962,67.46,45.42,-1146,51216,0,6086,54695,522877,11376741
530,2021-08-31,3628,587964,22,13691,23887,11465,157686,32733579,84790,9299398,6220739,6,25,319,344,267,308,2971,68.37,43.19,1025,52241,0,6086,54695,527183,11408609
531,2021-09-01,2871,590832,47,13743,22748,11465,175275,32908854,85471,9384869,6243487,2,27,319,346,232,222,2980,70.20,42.47,945,53186,0,6086,54695,530051,11439413
532,2021-09-02,2840,593668,33,13777,21702,11465,67456,32976310,81733,9466602,6265189,16,30,332,362,246,247,2988,71.30,41.81,604,53790,0,6086,54695,532887,11466985
533,2021-09-03,2729,596383,35,13813,15029,11465,37925,33014235,94191,9560793,6280218,2,36,328,364,201,252,2994,76.58,39.82,-1717,52073,0,6086,54695,535602,11495740
534,2021-09-04,2286,598667,30,13843,15526,11465,29768,33044003,77759,9638552,6295744,17,38,343,381,270,184,2998,76.05,40.59,-1158,50915,0,6086,54695,537886,11522842
535,2021-09-05,1291,599951,43,13886,7442,11465,20372,33064375,45753,9684305,6303186,0,38,343,381,184,95,3002,73.78,41.56,-2012,48903,0,6086,54695,539170,11523504
536,2021-09-06,1765,601716,47,13933,7216,11465,34277,33098652,39147,9723452,6310402,-2,36,343,379,229,197,3007,75.04,41.17,-1848,47055,0,6086,54695,540935,11552558
537,2021-09-07,2807,605158,38,13971,21714,11465,163712,33262364,88529,9811981,6332116,9,39,349,388,202,260,3015,74.23,39.42,243,47298,0,6086,54695,544377,11579860
538,2021-09-08,2198,607356,37,14014,17087,11465,160301,33422665,81576,9893557,6349203,2,40,350,390,212,249,3024,73.68,37.88,241,47539,0,6086,54695,546575,11608678
539,2021-09-09,2170,609519,43,14060,13938,11465,51229,33473894,77937,9971494,6363141,-6,41,343,384,181,216,3027,73.08,37.06,-471,47068,0,6086,54695,548738,11635474
540,2021-09-10,2132,611648,32,14102,13314,11465,33314,33507208,88340,10059834,6376455,-6,40,338,378,229,223,3036,73.08,37.60,-2869,44199,0,6086,54695,550867,11665847
541,2021-09-11,2197,613838,39,14141,13384,11465,27057,33534265,86749,10146583,6389839,-3,38,337,375,220,204,3041,74.02,36.94,-1071,43128,0,6086,54695,553057,11696468
542,2021-09-12,1319,615157,28,14169,7803,11465,18427,33552692,98172,10244755,6397642,3,38,340,378,183,98,3043,74.49,37.89,-2207,40921,0,6086,54695,554376,11697197
543,2021-09-13,1608,616765,51,14223,5463,11465,26034,33578726,72706,10317461,6403105,1,37,342,379,205,176,3046,73.37,37.80,-1491,39430,0,6086,54695,555984,11728334
544,2021-09-14,2919,620355,31,14268,17828,11465,77840,33656566,330210,10647671,6420933,-10,37,332,369,224,229,3061,72.76,37.09,521,39951,0,6086,54695,559574,11757399
545,2021-09-15,2422,622761,37,14311,14502,11465,38285,33694851,168328,10815999,6435435,-5,34,330,364,206,178,3069,71.27,37.21,819,40770,0,6086,54695,561980,11789457
546,2021-09-16,2322,625083,42,14354,14385,11465,9046,33703897,140910,10956909,6449820,-5,30,329,359,186,190,3077,70.81,36.44,-44,40726,0,6086,54695,564302,11817112
547,2021-09-17,2255,627314,39,14394,13904,11465,5482,33709379,191662,11148571,6463724,-7,30,322,352,193,218,3080,69.00,35.45,-2080,38646,0,6086,54695,566533,11848069
548,2021-09-18,2190,629498,37,14433,15178,11465,5127,33714506,157108,11305679,6478902,-4,28,320,348,192,149,3086,69.00,35.39,-671,37975,0,6086,54695,568717,11879410
549,2021-09-19,1305,630784,33,14466,9124,11465,3206,33717712,144784,11450463,6488026,0,30,318,348,128,76,3087,68.94,45.90,-1549,36426,0,6086,54695,570003,11880179
550,2021-09-20,2126,632908,39,14505,5652,11465,2589,33720301,74384,11524847,6493678,-6,29,313,342,212,149,3092,69.07,26.28,-594,35832,0,6086,54695,572127,11909198
551,2021-09-21,3040,636596,42,14548,20836,11465,10504,33730805,376109,11900956,6514514,-9,29,304,333,227,246,3096,68.18,35.31,1391,37223,0,6086,54695,575815,11934359
552,2021-09-22,2329,638921,26,14575,15453,11465,3217108,36947913,184220,12085176,6529967,0,30,303,333,,,3108,,,1057,38280,0,6086,54695,578140,11960582
553,2021-09-23,2125,641022,31,14606,12703,11465,18054,36965967,138576,12223752,6542670,-2,31,300,331,216,184,3118,66.60,34.57,352,38632,0,6086,54695,580241,11983436
554,2021-09-24,2046,643055,33,14639,14026,11465,153037,37119004,202580,12426332,6556696,0,33,298,331,158,214,3122,67.17,32.79,-1404,37228,0,6086,54695,582274,12011414
555,2021-09-25,1853,644869,16,14655,14231,11465,3391,37122395,171559,12597891,6570927,2,35,298,333,191,161,3128,67.74,32.77,-357,36871,0,6086,54695,584088,12041227
556,2021-09-26,1100,645969,24,14679,7598,11465,2219,37124614,146447,12744338,6578525,4,34,303,337,168,93,3129,66.23,33.90,-1041,35830,0,6086,54695,585188,12041797
557,2021-09-27,2130,648091,47,14727,5947,11465,1788,37126402,72744,12817082,6584472,-14,31,292,323,145,139,3134,67.00,33.60,-13,35817,0,6086,54695,587310,12066901
558,2021-09-28,2978,651378,22,14751,19136,11465,503075,37629477,369570,13186652,6603608,-1,31,291,322,206,197,3141,68.36,33.14,1112,36929,0,6086,54695,590597,12088975
559,2021-09-29,2187,653535,44,14795,14135,11465,905476,38534953,183945,13370597,6617743,1,31,292,323,158,178,3152,68.77,31.85,822,37751,0,6086,54695,592754,12112128
560,2021-09-30,2232,655767,33,14828,14789,11465,437797,38972750,135644,13506241,6632532,3,33,293,326,168,155,3160,67.64,31.55,645,38396,0,6086,54695,594986,12133980
561,2021-10-01,2636,658368,32,14860,14065,11465,1890,38974640,201378,13707619,6646597,3,34,295,329,153,187,3163,67.45,30.23,-976,37420,0,6086,54695,597587,12155993
562,2021-10-02,1837,660166,29,14889,13799,11465,903197,39877837,167178,13874797,6660396,3,36,296,332,163,125,3167,69.20,30.24,-594,36826,0,6086,54695,599385,12180365
563,2021-10-03,1165,661308,31,14920,7113,11465,26243,39904080,143394,14018191,6667509,0,34,298,332,138,74,3170,68.81,30.93,-1168,35658,0,6086,54695,600527,12180755
564,2021-10-04,2125,663433,36,14956,5064,11465,56728,39960808,69361,14087552,6672573,10,38,304,342,146,152,3180,67.90,30.21,-102,35556,0,6086,54695,602652,12200590
565,2021-10-05,2876,666517,34,14991,17941,11465,447034,40407842,352370,14439922,6690514,-8,34,300,334,194,167,3188,66.73,30.24,904,36460,0,6086,54695,605736,12219868
566,2021-10-06,2331,668811,21,15012,13759,11465,440536,40848378,182460,14622382,6704273,13,40,307,347,206,161,3190,67.44,30.83,1020,37480,0,6086,54695,608030,12238607
567,2021-10-07,2249,671040,30,15042,13844,11465,2295,40850673,134490,14756872,6718117,-12,41,294,335,185,165,3202,68.10,30.85,114,37594,0,6086,54695,610259,12255563
568,2021-10-08,2324,673317,22,15069,12504,11465,79,40850752,189242,14946114,6730621,-1,46,288,334,178,163,3202,68.10,30.62,-1395,36199,0,6086,54695,612536,12275855
569,2021-10-09,2197,675479,36,15105,11790,11465,953281,41804033,152973,15099087,6742411,-3,44,287,331,206,127,3209,66.15,31.75,-172,36027,0,6086,54695,614698,12296873
570,2021-10-10,1358,676799,30,15135,7076,11465,32353,41836386,142552,15241639,6749487,2,44,289,333,187,65,3210,68.23,33.78,-780,35247,0,6086,54695,616018,12298000
571,2021-10-11,2383,679157,41,15177,5049,11465,33941,41870327,67794,15309433,6754536,-2,44,287,331,162,146,3212,70.04,33.10,316,35563,0,6086,54695,618376,12315494
572,2021-10-12,3065,682394,32,15210,17006,11465,384356,42254683,353429,15662862,6771542,5,44,292,336,,,3217,,,1406,36969,0,6086,54695,621613,12331868
573,2021-10-13,2338,684706,31,15241,13786,11465,544507,42799190,178368,15841230,6785328,7,46,297,343,220,171,3221,70.00,33.46,1205,38174,0,6086,54695,623925,12347016
574,2021-10-14,2601,687278,46,15289,13527,11465,37732,42836922,138113,15979343,6798855,4,42,305,347,209,146,3224,69.61,34.14,450,38624,0,6086,54695,626497,12360246
575,2021-10-15,2665,689896,27,15317,12317,11465,253528,43090450,170667,16150010,6811172,21,45,323,368,210,168,3231,72.08,34.43,-673,37951,0,6086,54695,629115,12376355
576,2021-10-16,2313,692197,30,15348,11891,11465,355197,43445647,148508,16298518,6823063,-7,42,319,361,192,125,3239,72.19,35.12,157,38108,0,6086,54695,631416,12393460
577,2021-10-17,1712,693886,27,15375,7025,11465,60386,43506033,140293,16438811,6830088,-4,43,314,357,212,71,3243,73.60,37.36,-537,37571,0,6086,54695,633105,12394549
578,2021-10-18,3164,697033,43,15418,5496,11465,135730,43641763,70191,16509002,6835584,-10,40,307,347,192,156,3249,70.84,37.36,535,38106,0,6086,54695,636252,12422985
579,2021-10-19,3739,700959,29,15447,17790,11465,430911,44072674,358594,16867596,6853374,9,44,312,356,213,186,3253,70.82,36.60,2128,40234,0,6086,54695,640178,12450262
580,2021-10-20,3279,704211,38,15485,14296,11465,495715,44568389,190647,17058243,6867670,-5,40,311,351,220,202,3259,73.35,35.84,2103,42337,0,6086,54695,643430,12477519
581,2021-10-21,3407,707587,34,15519,14509,11465,2925,44571314,150952,17209195,6882179,-4,41,306,347,250,165,3270,74.32,37.03,1253,43590,0,6086,54695,646806,12503723
582,2021-10-22,3585,711128,36,15555,13925,11465,0,44571314,213021,17422216,6896104,1,40,308,348,239,200,3279,71.24,36.93,456,44046,0,6086,54695,650347,12531351
583,2021-10-23,3199,714283,43,15598,13428,11465,2656,44573970,180633,17602849,6909532,5,43,310,353,253,128,3282,72.78,38.27,839,44885,0,6086,54695,653502,12557691
584,2021-10-24,2098,716358,30,15628,7333,11465,912729,45486699,141605,17744454,6916865,12,44,321,365,219,72,3282,73.44,40.66,-154,44731,0,6086,54695,655577,12558035
585,2021-10-25,3937,720295,54,15682,5970,11465,30157,45516856,70823,17815277,6922835,-11,40,314,354,261,174,3285,73.73,41.91,1633,46364,0,6086,54695,659514,12583526
586,2021-10-26,4165,724571,25,15707,18001,11465,113306,45630162,366966,18182243,6940836,26,53,327,380,246,211,3290,77.06,41.60,2125,48489,0,6086,54695,663790,12603840
587,2021-10-27,3651,728210,63,15770,12412,11465,1289,45631451,182293,18364536,6953248,7,56,331,387,289,208,3299,78.54,42.04,2286,50775,0,6086,54695,667429,12630079
588,2021-10-28,2984,731167,31,15801,12905,11465,753994,46385445,180223,18544759,6966153,4,55,336,391,295,158,3302,80.28,43.38,610,51385,0,6086,54695,670386,12630449
589,2021-10-29,3643,734778,55,15856,5482,11465,5925,46391370,56003,18600762,6971635,1,55,337,392,277,161,3303,80.49,44.57,352,51737,0,6086,54695,673997,12661055
590,2021-10-30,4696,739448,38,15894,16366,11465,806352,47197722,260618,18861380,6988001,12,60,344,404,323,181,3312,80.63,46.65,2351,54088,0,6086,54695,678667,12690458
591,2021-10-31,2727,742170,44,15938,8110,11465,44452,47242174,150152,19011532,6996111,17,64,357,421,249,104,3313,81.62,47.93,154,54242,0,6086,54695,681389,12690809
592,2021-11-01,5449,747595,52,15990,6090,11465,33703,47275877,76503,19088035,7002201,9,66,364,430,321,204,3316,82.36,47.90,2783,57025,0,6086,54695,686814,12719596
593,2021-11-02,6700,754451,59,16050,22008,11465,60642,47336519,397400,19485435,7024209,4,64,370,434,343,243,3324,83.72,48.15,4526,61551,0,6086,54695,693670,12751618
594,2021-11-03,6150,760592,49,16109,16652,11465,396093,47732612,215757,19701192,7040861,-3,68,363,431,363,256,3328,87.08,48.48,4420,65971,0,6086,54695,699811,12787753
595,2021-11-04,6808,767376,42,16151,16937,11465,728420,48461032,186121,19887313,7057798,10,72,369,441,356,215,3334,85.63,50.19,3638,69609,0,6086,54695,706595,12824577
596,2021-11-05,6909,774265,48,16200,16764,11465,413206,48874238,246386,20133699,7074562,9,72,378,450,,,3347,,,2943,72552,0,6086,54695,713484,12866026
