id,date,new_cases,confirmed,new_deaths,total_deaths,new_reinfections,total_reinfections,new_hospital_entries,new_icu_entries,new_critical,total_critical,new_tests_combined,tests_combined,positive_rate,pos_rate_eody,total_vaccinations
1,2020-01-05,0,0,0,0,0,,,0,0,,0,0,0.00,,
2,2020-01-12,0,0,0,0,0,,,0,0,,0,0,0.00,,
3,2020-01-19,0,0,0,0,0,,,0,0,,0,0,0.00,,
4,2020-01-26,0,0,0,0,0,,,0,0,,0,0,0.00,,
5,2020-02-02,0,0,0,0,0,,,0,0,,0,0,0.00,,
6,2020-02-09,0,0,0,0,0,,,0,0,,0,0,0.00,,
7,2020-02-16,0,0,0,0,0,,,0,0,,0,0,0.00,,
8,2020-02-23,0,0,0,0,0,,,0,0,,0,0,0.00,,
9,2020-03-01,6,6,0,0,0,,,0,0,,200,200,3.00,3.00,
10,2020-03-08,80,86,0,0,0,,,2,0,,835,1035,7.73,7.73,
11,2020-03-15,327,413,4,4,0,,,13,0,,4679,5714,5.72,5.72,
12,2020-03-22,381,794,13,17,0,0,,42,34,34,4211,9925,3.84,3.84,0
13,2020-03-29,538,1332,25,42,0,0,,55,35,69,-932,8993,5.98,5.98,0
14,2020-04-05,534,1866,35,77,0,0,,40,24,93,739,9732,5.49,5.49,0
15,2020-04-12,289,2155,22,99,0,0,,20,-17,76,647,10379,2.78,2.78,0
16,2020-04-19,118,2273,14,113,0,0,,17,-9,67,540,10919,1.08,1.08,0
17,2020-04-26,303,2576,21,134,0,0,,10,-21,46,3321,14240,2.13,2.13,0
18,2020-05-03,104,2680,10,144,0,0,,4,-9,37,4179,18419,0.56,0.56,0
19,2020-05-10,100,2780,9,153,0,0,,4,-7,30,8434,26853,0.37,0.37,0
20,2020-05-17,104,2884,13,166,0,0,,5,-8,22,3266,30119,0.35,0.35,0
21,2020-05-24,47,2931,7,173,0,0,,4,-3,19,4055,34174,0.14,0.14,0
22,2020-05-31,47,2978,6,179,0,0,,2,-6,13,-6677,27497,0.17,0.17,0
23,2020-06-07,135,3113,3,182,0,0,,3,-13,0,4082,31579,0.43,0.43,0
24,2020-06-14,120,3233,2,184,0,0,,8,13,13,3788,35367,0.34,0.34,0
25,2020-06-21,114,3248,6,190,0,0,,2,-4,9,-671,34696,0.33,0.33,0
26,2020-06-28,120,3368,1,191,0,0,,3,1,10,268,34964,0.34,0.34,0
27,2020-07-05,204,3572,1,192,0,0,,3,1,11,8474,43438,0.47,0.47,0
28,2020-07-12,257,3829,2,194,0,0,,4,-1,10,19555,62993,0.41,0.41,0
29,2020-07-19,176,4005,1,195,0,0,,2,3,13,1689,64682,0.27,0.27,0
30,2020-07-26,247,4252,7,202,0,0,,7,-4,9,-11321,53361,0.46,0.46,0
31,2020-08-02,560,4812,6,208,0,0,,11,3,12,3902,57263,0.98,0.98,0
32,2020-08-09,1081,5893,6,214,0,0,,16,10,22,12798,70061,1.54,1.54,0
33,2020-08-16,1598,7491,17,231,0,0,,12,2,24,9350,79411,2.01,2.01,0
34,2020-08-23,1664,9155,14,245,0,0,,19,7,31,2639,82050,2.03,2.03,0
35,2020-08-30,1446,10601,20,265,0,0,,18,4,35,9017,91067,1.59,1.59,0
36,2020-09-06,1345,11946,26,291,0,0,209,22,6,41,-3129,87938,1.53,1.53,0
37,2020-09-13,1768,13714,20,311,0,0,260,36,13,54,8208,96146,1.83,1.83,0
38,2020-09-20,2242,15956,37,348,0,0,342,45,24,78,-11144,85002,2.64,2.64,0
39,2020-09-27,2195,18151,39,387,0,0,335,29,-10,68,-8623,76379,2.87,2.87,0
40,2020-10-04,2391,20542,27,414,0,0,398,48,14,82,442,76821,3.11,3.11,0
41,2020-10-11,2493,23035,43,457,0,0,370,40,11,93,7249,84070,2.96,2.96,0
42,2020-10-18,3349,26384,62,519,0,0,419,34,-9,84,45691,129761,2.58,2.58,0
43,2020-10-25,6317,32701,65,584,0,0,590,57,0,84,17827,147588,4.28,4.28,0
44,2020-11-01,11339,44040,65,649,0,0,955,99,56,140,-1890,145698,7.78,7.78,0
45,2020-11-08,17558,61598,182,831,0,0,1717,157,88,228,20734,166432,10.53,10.53,0
46,2020-11-15,19054,80652,342,1173,0,0,2759,288,164,392,6490,172922,10.98,10.98,0
47,2020-11-22,17112,97764,590,1763,0,0,3190,357,148,540,13075,185997,9.17,9.17,0
48,2020-11-29,12934,110698,684,2447,0,0,2870,313,63,603,-3122,182875,7.04,7.04,0
49,2020-12-06,10612,121310,702,3149,0,0,2406,280,-3,600,-15458,167417,6.34,6.34,0
50,2020-12-13,8293,129603,605,3754,0,0,1933,244,-48,552,17221,184638,4.49,4.49,0
51,2020-12-20,6012,135615,525,4279,0,0,1522,197,-37,515,11707,196345,3.06,3.06,0
52,2020-12-27,4288,139903,403,4682,0,0,1019,172,-46,469,-47884,148461,2.89,2.89,0
53,2021-01-03,4508,144411,320,5002,0,0,1000,126,-48,421,629,149090,3.02,3.02,3869
54,2021-01-10,4622,149033,280,5282,0,0,856,107,-68,353,31408,180498,2.56,2.56,44645
55,2021-01-17,3579,152612,199,5481,0,0,931,105,-33,320,13004,193502,1.85,1.85,80391
56,2021-01-24,3373,155985,177,5658,0,0,724,89,-32,288,-17319,176183,1.91,1.91,160101
57,2021-01-31,5467,161452,167,5825,0,0,931,67,-33,255,33589,209772,2.61,2.61,271287
58,2021-02-07,7435,168887,171,5996,0,0,1224,111,7,262,43005,252777,2.94,2.94,397857
59,2021-02-14,8501,177388,154,6150,0,0,1440,156,39,301,29017,281794,3.02,3.02,526369
60,2021-02-21,8140,185528,183,6333,0,0,1527,143,25,326,-50903,230891,3.52,3.52,697245
61,2021-02-28,11855,197383,219,6552,0,0,1999,200,65,391,64779,295670,4.01,4.01,885821
62,2021-03-07,14550,211933,271,6823,0,0,2572,220,75,466,28533,324203,4.49,4.49,1091749
63,2021-03-14,16805,228738,361,7184,0,0,3169,308,98,564,-33872,290331,5.79,5.79,1283472
64,2021-03-21,16562,245300,392,7576,0,0,3307,341,110,674,-24572,265759,6.23,6.23,1436491
65,2021-03-28,17842,263142,435,8011,0,0,3129,338,61,735,13982,279741,6.38,6.38,1604238
66,2021-04-04,22224,285366,515,8526,0,0,3475,342,14,749,54281,334022,6.65,6.65,1830362
67,2021-04-11,20984,306350,517,9043,0,0,3750,350,31,780,239595,573617,3.66,3.66,2169353
68,2021-04-18,19756,326106,560,9603,0,0,3585,392,61,841,255920,829537,2.38,2.38,2491857
69,2021-04-25,18137,344243,520,10123,0,0,3306,332,-25,816,334425,1163962,1.56,1.56,2821625
70,2021-05-02,14751,358994,507,10630,0,0,3018,332,-5,811,-397134,766828,1.92,1.92,3115339
71,2021-05-09,15262,374256,512,11142,0,0,2642,232,-83,728,1689663,2456491,0.62,0.62,3647616
72,2021-05-16,15064,389320,348,11490,0,0,2193,214,-72,656,-944670,1511821,1.00,1.00,4292541
73,2021-05-23,12435,401755,342,11832,0,0,1890,159,-87,569,2664954,4176775,0.30,0.30,4913334
74,2021-05-30,11019,412774,269,12101,0,0,1424,139,-72,497,-616968,3559807,0.31,0.31,5498042
75,2021-06-06,7484,420258,219,12320,0,0,1111,104,-99,398,-350321,3209486,0.23,0.23,6156375
76,2021-06-13,4940,425198,137,12457,0,0,739,65,-40,358,8779,3218265,0.15,0.15,6835783
77,2021-06-20,3095,428293,129,12586,0,0,453,54,-62,296,-323386,2894879,0.11,0.11,7508584
78,2021-06-27,2575,5709,104,288,0,0,343,33,-65,231,-161613,2733266,0.09,0.09,8098959
79,2021-07-04,5176,10885,63,351,0,0,268,18,-54,177,-1228816,1504450,0.34,0.34,8710475
80,2021-07-11,13648,24533,56,407,0,0,439,13,-35,142,109355,1613805,0.85,0.85,9233521
81,2021-07-18,17966,42499,66,473,0,0,807,29,-19,123,-288179,1325626,1.36,1.36,9723233
82,2021-07-25,18091,60590,44,517,0,0,1115,55,11,134,-127378,1198248,1.51,1.51,10162629
83,2021-08-01,18513,79103,87,604,0,0,1211,97,42,176,401791,1600039,1.34,1.34,10538744
84,2021-08-08,19594,98697,115,719,0,0,1374,97,28,204,-97301,1502738,1.51,1.51,10807733
85,2021-08-15,22568,121265,146,865,0,0,1633,117,37,241,-264624,1238114,2.15,2.15,10988838
86,2021-08-22,22379,143644,208,1073,0,0,1830,162,77,318,63719,1301833,2.02,2.02,11154395
87,2021-08-29,21724,165368,236,1309,0,0,1848,146,16,334,-618,1301215,1.94,1.94,11343445
88,2021-09-05,17538,182906,251,1560,0,0,1621,179,47,381,-48800,1252415,1.61,1.61,11523504
89,2021-09-12,14666,197572,278,1838,0,0,1456,135,-3,378,-50657,1201758,1.40,1.40,11697197
90,2021-09-19,15322,212894,269,2107,0,0,1334,128,-30,348,221217,1422975,1.21,1.21,11891452
91,2021-09-26,14150,227044,218,2325,0,0,1334,128,-11,337,1308825,2731800,0.56,0.56,12063951
92,2021-10-03,14991,242035,242,2567,0,0,1131,132,-5,332,1693757,4425557,0.36,0.36,12225389
93,2021-10-10,15384,257419,212,2779,0,0,1302,146,1,333,-1051338,3374219,0.48,0.48,12412827
94,2021-10-17,17515,274934,252,3031,0,0,1427,151,24,357,-691752,2682467,0.68,0.68,12596452
95,2021-10-24,22654,297588,254,3285,0,0,1586,152,8,365,783769,3466236,0.69,0.69,12759982
96,2021-10-31,26720,324308,326,3611,0,0,1940,211,56,421,-187338,3278898,0.86,0.86,12892763
97,2021-11-07,43388,367696,348,3959,0,0,2519,229,49,470,1256570,4535468,1.06,1.06,13104188
98,2021-11-14,46461,414157,470,4429,0,0,2873,267,66,536,866809,5402277,0.95,0.95,13414759
99,2021-11-21,46908,461065,583,5012,0,0,3181,330,54,590,-32498,5369779,0.97,0.97,13827670
100,2021-11-28,45124,506189,632,5644,0,0,3323,351,57,647,-158708,5211071,0.94,0.94,14346455
101,2021-12-05,41133,547322,638,6282,0,0,3039,370,68,715,159832,5370903,0.87,0.87,14990602
102,2021-12-12,35783,583105,668,6950,0,0,2752,326,-7,708,-170501,5200402,0.78,0.78,15754335
103,2021-12-19,30830,613935,623,7573,0,0,2344,283,-46,662,262200,5462602,0.60,0.60,16503921
104,2021-12-26,46302,660237,530,8103,0,0,2222,284,-38,624,-170297,5292305,1.19,1.19,17010188
105,2022-01-02,201481,861718,503,8606,0,0,2895,251,2,626,-1561715,3730590,5.85,5.85,17531789
106,2022-01-09,241325,1103043,496,9102,0,0,3993,277,16,642,944106,4674696,5.72,5.72,18050360
107,2022-01-16,145822,1248865,615,9717,0,0,3911,314,38,680,813896,5488592,2.78,2.78,18588675
108,2022-01-23,132226,1381091,675,10392,0,0,3440,301,-15,665,-175835,5312757,2.61,2.61,19031146
109,2022-01-30,127650,1508741,732,11124,0,0,3045,215,-94,571,-1212541,4100216,3.24,3.24,19319108
110,2022-02-06,124696,1633437,714,11838,0,0,3278,225,-20,551,1088120,5188336,2.50,2.50,19580490
111,2022-02-13,125165,1758602,605,12443,0,0,2841,182,-52,499,-749808,4438528,2.97,2.97,19822367
112,2022-02-20,123799,1882401,572,13015,0,0,2532,178,-28,471,2438544,6877072,1.89,1.89,19982991
113,2022-02-27,104780,1987181,452,13467,0,0,2190,126,-54,417,-1567066,5310006,2.09,2.09,20125573
114,2022-03-06,103669,2090850,402,13869,0,0,1986,120,-41,376,-491780,4818226,2.28,2.28,20233125
115,2022-03-13,129988,2220838,390,14259,0,0,1985,113,-20,356,-274776,4543450,3.02,3.02,20314595
116,2022-03-20,152116,2372954,367,14626,0,0,2360,102,-10,346,369728,4913178,3.27,3.27,20400742
117,2022-03-27,143816,2516770,366,14992,0,0,2822,104,-4,342,-539798,4373380,3.48,3.48,20473051
118,2022-04-03,143848,2660618,416,15408,0,0,3082,123,14,356,683551,5056931,3.00,3.00,20568925
119,2022-04-10,98897,2759515,456,15864,118885,118885,2482,132,1,357,-1391522,3665409,2.86,6.30,20630002
120,2022-04-17,62233,2821748,419,16283,1265,120150,1724,90,-44,313,-478017,3187392,2.07,2.11,20719961
121,2022-04-24,44025,2865773,319,16602,985,121135,1318,51,-36,277,-2047381,1140011,4.32,4.42,20794891
122,2022-05-01,45138,2910911,269,16871,1959,123094,1206,47,-39,238,-96397,1043614,4.85,5.06,20869575
123,2022-05-08,32496,2943407,189,17060,2860,125954,919,28,-34,204,-292470,751144,4.84,5.26,20922881
124,2022-05-15,30782,2974189,153,17213,3066,129020,776,32,-28,176,-14505,736639,4.70,5.17,20957637
125,2022-05-22,26875,3001064,132,17345,2966,131986,679,25,-20,156,-42095,694544,4.36,4.84,20985720
126,2022-05-29,25494,3026558,102,17447,2832,134818,623,19,-24,132,-28852,665692,4.33,4.82,21008718
127,2022-06-05,25086,3051644,93,17540,3034,137852,600,26,-14,118,-20400,645292,4.41,4.94,21027982
128,2022-06-12,30745,3082389,99,17639,3858,141710,674,15,-8,110,-17636,627656,5.54,6.24,21044191
129,2022-06-19,46178,3128567,71,17710,6541,148251,946,21,-9,101,44448,672104,7.70,8.79,21054935
130,2022-06-26,74364,3202931,96,17806,11914,160165,1362,22,-8,93,126539,798643,10.44,12.11,21075242
131,2022-07-03,104747,3307678,129,17935,19711,179876,1962,35,5,98,152041,950684,12.30,14.62,21103711
132,2022-07-10,123806,3431484,180,18115,25766,205642,2293,50,5,103,66649,1017333,13.55,16.37,21144631
133,2022-07-17,122643,3554127,223,18338,-716,204926,2603,50,6,109,39963,1057296,12.86,12.79,21184105
134,2022-07-24,111502,3665629,307,18645,26718,231644,2805,70,6,115,-85814,971482,12.70,15.74,21217816
135,2022-07-31,98861,3764490,395,19040,25855,257499,2570,64,17,132,-79950,891532,12.25,15.45,21247055
136,2022-08-07,80050,3844540,363,19403,24446,281945,2353,43,6,138,-88360,803172,10.99,14.34,21273010
137,2022-08-14,58577,3903117,295,19698,21088,303033,1958,51,-18,120,-142157,661015,9.74,13.24,21295206
138,2022-08-21,43917,3947034,269,19967,15479,318512,1531,56,-2,118,-118774,542241,8.93,12.07,21306237
139,2022-08-28,39306,3986340,223,20190,12269,330781,1188,37,14,132,77197,619438,7.03,9.23,21322162
140,2022-09-04,31036,4017376,188,20378,11633,342414,983,27,-15,117,20683,640121,5.38,7.40,21337553
141,2022-09-11,26255,4043631,129,20507,9223,351637,792,25,-16,101,2289,642410,4.54,6.13,21351104
142,2022-09-18,27374,4071005,115,20622,7390,359027,821,25,0,101,39506,681916,4.47,5.68,21369196
143,2022-09-25,33079,4104084,101,20723,8675,367702,820,17,-19,82,46103,728019,5.04,6.36,21400465
144,2022-10-02,41207,4145291,91,20814,11642,379344,1074,20,-3,79,39536,767555,5.95,7.63,21422779
145,2022-10-09,39791,4185082,118,20932,13662,393006,1108,21,-13,66,4455,772010,5.71,7.67,21472967
146,2022-10-16,43578,4228660,114,21046,11772,404778,1355,37,-4,62,-4780,767230,6.29,7.99,21534230
147,2022-10-23,41373,4270033,151,21197,11601,416379,1294,26,12,74,-1854,765376,5.98,7.66,21599632
148,2022-10-30,41133,4311166,170,21367,11653,428032,1325,33,8,82,-68100,697276,6.53,8.38,21652943
149,2022-11-06,46212,4357378,152,21519,12290,440322,1461,32,3,85,95097,792373,6.45,8.17,21714370
150,2022-11-13,41738,4399116,126,21645,15285,455607,1292,35,4,89,-30673,761700,6.06,8.28,21771745
151,2022-11-20,39465,4438581,166,21811,14538,470145,1360,38,-8,81,-12902,748798,5.84,7.99,21823401
152,2022-11-27,31609,4470190,132,21943,14526,484671,1287,31,8,89,-32083,716715,4.90,7.15,21869756
153,2022-12-04,31490,4501680,159,22102,12296,496967,1191,38,4,93,-18514,698201,5.01,6.97,21910998
154,2022-12-11,36508,4538188,144,22246,12249,509216,1434,38,-2,91,35119,733320,5.53,7.39,21950857
155,2022-12-18,33272,4571460,158,22404,15547,524763,1349,44,-3,88,-8653,724667,5.10,7.48,21986456
156,2022-12-25,26921,4598381,170,22574,14249,539012,1250,51,16,104,-87771,636896,4.69,7.18,22007203
157,2023-01-01,34712,4633093,154,22728,20961,559973,1519,60,5,109,-96280,540616,7.12,11.42,22017153
158,2023-01-08,39319,4672412,169,22897,3826,563799,1632,53,19,128,58478,599094,7.29,8.00,22030918
159,2023-01-15,34620,4707032,206,23103,18021,581820,1748,69,19,147,139487,738581,5.20,7.90,22059615
160,2023-01-22,24354,4731386,183,23286,13301,595121,1535,51,6,153,-41971,696610,3.88,6.00,22080141
161,2023-01-29,15380,4746766,179,23465,7975,603096,1112,49,-18,135,-47202,649408,2.63,4.00,22090834
162,2023-02-05,12032,4758798,120,23585,7683,610779,964,33,-8,127,-23650,625758,2.14,3.50,22098167
163,2023-02-12,11224,4770022,113,23698,7276,618055,854,31,-10,117,-55236,570522,2.18,3.60,22102104
164,2023-02-19,13029,4783051,101,23799,8596,626651,951,21,-16,101,44477,614999,2.35,3.90,22105855
165,2023-02-26,14969,4798020,94,23893,10161,636812,1063,29,-6,95,5114,620113,2.68,4.50,22109109
166,2023-03-05,13365,4811385,96,23989,10171,646983,925,33,0,95,-28023,592090,2.50,4.41,22111284
167,2023-03-12,10361,4821746,76,24065,7826,654809,771,26,1,96,17231,609321,1.88,3.31,22113592
168,2023-03-19,7500,4829246,77,24142,5996,660805,715,18,-25,71,-34690,574631,1.45,2.61,22115497
169,2023-03-26,7318,4836564,66,24208,6461,667266,691,17,4,75,-48202,526429,1.54,2.91,22117231
170,2023-04-02,7142,4843706,50,24258,6710,673976,667,15,-10,65,-122150,404279,1.96,3.81,22118504
171,2023-04-09,6468,4850174,49,24307,5084,679060,666,22,4,69,-83999,320280,2.25,4.01,22119553
172,2023-04-16,6149,4856323,46,24353,3924,682984,708,16,-12,57,-89001,231279,2.95,4.84,22120079
173,2023-04-23,8656,4864979,47,24400,6071,689055,813,17,7,64,27404,258683,3.71,6.32,22120521
174,2023-04-30,7293,4872272,61,24461,6092,695147,732,16,-3,61,42533,301216,2.68,4.92,22121364
175,2023-05-07,6621,4878893,55,24516,6066,701213,636,20,0,61,-26107,275109,2.67,5.12,22121963
176,2023-05-14,7212,4886105,56,24572,7956,709169,557,19,-5,56,14898,290007,2.76,5.81,22122601
177,2023-05-21,7592,4893697,56,24628,7391,716560,636,13,-3,53,-12231,277776,3.04,6.01,22123177
178,2023-05-28,6132,4899829,50,24678,5871,722431,629,8,-13,40,-11285,266491,2.56,5.01,22123622
179,2023-06-04,4260,4904089,44,24722,4554,726985,486,16,-3,37,-22359,244132,1.94,4.02,22124069
180,2023-06-11,3145,4907234,39,24761,2901,729886,356,4,-8,29,-19703,224429,1.56,3.01,22124386
181,2023-06-18,2468,4909702,20,24781,1723,731609,225,5,0,29,8697,233126,1.18,2.01,22124737
182,2023-06-25,2367,4912069,20,24801,1613,733222,211,6,-2,27,-11083,222043,1.19,2.01,22125051
183,2023-07-02,1851,4913920,18,24819,1984,735206,182,4,-3,24,-8096,213947,0.97,2.01,22125339
184,2023-07-09,1873,4915793,16,24835,1843,737049,198,5,-4,20,-6777,207170,1.01,2.01,22125623
185,2023-07-16,1989,4917782,17,24852,1449,738498,226,2,-3,17,-14865,192305,1.16,2.01,22125890
186,2023-07-23,2598,4920380,17,24869,2619,741117,306,7,0,17,-9672,182633,1.60,3.20,22126088
187,2023-07-30,3376,4923756,26,24895,3300,744417,321,9,-1,16,-41535,141098,2.69,5.32,22126327
188,2023-08-06,4425,4928181,27,24922,4122,748539,469,8,2,18,-18648,122450,4.05,7.83,22126500
189,2023-08-13,5478,4933659,21,24943,4887,753426,563,5,-4,14,-6940,115510,5.30,10.03,22126678
190,2023-08-20,5781,4939440,37,24980,5758,759184,641,12,-1,13,-12771,102739,6.29,12.55,22126806
191,2023-08-27,6876,4946316,43,25023,7259,766443,629,21,12,25,30843,133582,5.75,11.83,22126973
192,2023-09-03,7379,4953695,39,25062,7450,773893,622,9,-2,23,14335,147917,5.59,11.24,22127168
193,2023-09-10,7543,4961238,39,25101,7646,781539,688,10,2,25,6564,154481,5.49,11.05,22127341
194,2023-09-17,8639,4969877,45,25146,9895,791434,733,9,0,25,14752,169233,5.75,12.34,22127565
195,2023-09-24,11341,4981218,44,25190,14135,805569,869,16,8,33,27413,196646,6.47,14.54,22127896
196,2023-10-01,11484,4992702,56,25246,15150,820719,868,14,3,36,1199,197845,6.48,15.04,22128233
197,2023-10-08,12542,5005244,56,25302,15069,835788,974,18,2,38,7464,205309,6.82,15.03,22128648
198,2023-10-15,13148,5018392,56,25358,14850,850638,1082,33,15,53,5031,210340,6.96,14.83,22128866
199,2023-10-22,11864,5030256,55,25413,13517,864155,1065,20,3,56,-3016,207324,6.36,13.62,22135043
200,2023-10-29,9611,5039867,73,25486,11126,875281,903,13,-7,49,-20312,187012,5.71,12.33,22147761
201,2023-11-05,9282,5049149,62,25548,11379,886660,781,25,-8,41,7606,194618,5.31,11.82,22163624
202,2023-11-12,7757,5056906,57,25605,9784,896444,793,23,2,43,-9347,185271,4.65,10.53,22181384
203,2023-11-19,7801,5064707,30,25635,9692,906136,787,12,0,43,-7303,177968,4.87,10.94,22201027
204,2023-11-26,8348,5073055,47,25682,11416,917552,838,26,7,50,-863,177105,5.22,12.43,22219928
205,2023-12-03,9898,5082953,46,25728,13526,931078,991,22,4,54,11685,188790,5.23,13.83,22255810
206,2023-12-10,11906,5094859,59,25787,16686,947764,1176,28,5,59,14099,202889,5.84,15.73,22271159
207,2023-12-17,14576,5109435,74,25861,21885,969649,1373,29,3,62,25491,228380,6.34,17.74,22283865
208,2023-12-24,16944,5126379,83,25944,23891,993540,1496,18,-8,54,10554,238934,7.06,19.02,22295663
209,2023-12-31,19326,5145705,94,26038,25232,1018772,1818,37,16,70,-26576,212358,9.00,23.31,22310100
210,2024-01-07,17912,5163617,111,26149,26663,1045435,1679,40,8,78,31625,243983,7.30,20.24,22342919
211,2024-01-14,12166,5175783,121,26270,19874,1065309,1162,34,-10,68,9546,253529,4.77,14.02,22363448
212,2024-01-21,7118,5182901,91,26361,12030,1077339,842,31,1,69,-38406,215123,3.29,9.92,22417414
213,2024-01-28,4361,5187262,70,26431,8081,1085420,546,12,-18,51,-27950,187173,2.32,7.41,22442023
214,2024-02-04,3497,5190759,35,26466,6826,1092246,439,2,-6,45,-15038,172135,2.02,6.71,22442023
215,2024-02-11,3407,5194166,43,26509,6654,1098900,446,7,-11,34,5239,177374,2.12,6.32,22442023
216,2024-02-18,2381,5196547,23,26532,4629,1103529,300,5,-1,33,-10758,166616,1.59,4.71,22458163
217,2024-02-25,1958,5198505,19,26551,3677,1107206,298,6,-3,30,-8607,158009,1.38,4.01,22460108
218,2024-03-03,1423,5199928,14,26565,2998,1110204,208,1,-8,22,-8370,149639,1.05,3.31,22462015
219,2024-03-10,1087,5201015,14,26579,2441,1112645,143,0,-7,15,-3838,145801,0.83,2.71,22464199
220,2024-03-17,1266,5202281,9,26588,3386,1116031,127,4,-2,13,-1982,143819,0.97,3.62,22465044
221,2024-03-24,695,5202976,7,26595,1724,1117755,104,1,0,13,-20892,122927,0.56,2.20,22465539
222,2024-03-31,917,5203893,9,26604,2542,1120297,79,1,-1,12,-1978,120949,0.84,3.21,22465945
223,2024-04-07,1003,5204896,6,26610,2754,1123051,77,0,-4,8,10215,131164,0.84,3.22,22466326
224,2024-04-14,1184,5206080,4,26614,3755,1126806,66,0,-1,7,-2817,128347,1.01,4.32,22466648
225,2024-04-21,1333,5207413,6,26620,4207,1131013,81,2,-1,6,-6633,121714,1.21,5.12,22466892
226,2024-04-28,1005,5208418,2,26622,3265,1134278,83,3,3,9,-7584,114130,0.98,4.21,22467100
227,2024-05-05,330,5208748,2,26624,495,1134773,82,4,0,9,-35867,78263,0.47,1.19,22467118
228,2024-05-12,548,5209296,4,26628,854,1135627,78,1,-4,5,-9420,68843,0.89,2.32,22467316
229,2024-05-19,917,5210213,2,26630,1576,1137203,117,1,1,6,28137,96980,1.06,2.91,22467453
230,2024-05-26,1044,5211257,6,26636,1957,1137203,158,3,2,8,-8716,88264,1.31,3.81,22467567
231,2024-06-02,1297,5212554,3,26639,2286,1141446,153,1,0,8,-731,87533,4.60,4.61,22467719
232,2024-06-09,1931,5214485,8,26647,3504,1144950,235,5,2,10,-739,86794,2.47,7.02,22467812
233,2024-06-16,2127,5216612,6,26653,3871,1148821,324,3,2,12,-2826,83968,2.82,8.02,22467898
234,2024-06-23,3096,5219708,19,26672,4755,1153576,487,4,-5,7,3752,87720,3.89,10.09,22467978
235,2024-06-30,3302,5223010,24,26696,6077,1159653,472,6,1,8,-3367,84353,4.39,12.52,22467985
236,2024-07-07,4135,5227145,22,26718,7101,1166754,575,10,5,13,10224,94577,4.87,13.34,22467985
237,2024-07-14,4535,5231680,28,26746,8756,1175510,669,13,4,17,4455,99032,5.09,15.04,22468502
238,2024-07-21,5426,5237106,42,26788,9542,1185052,788,6,0,17,7282,106314,5.66,15.75,22468757
239,2024-07-28,6114,5243220,47,26835,10723,1195775,923,19,4,21,6967,113281,5.96,16.55,22468969
240,2024-08-04,5825,5249045,41,26876,10238,1206013,833,12,4,25,-4756,108525,5.92,16.44,22469133
241,2024-08-11,5541,5254586,40,26916,8916,1214894,817,13,-5,20,-18378,90147,6.80,17.83,22469282
242,2024-08-18,4439,5259025,37,26953,6985,1221879,771,11,7,27,-25085,65062,7.53,19.57,22469373
243,2024-08-25,5169,5264194,46,26999,8509,1230388,815,19,11,38,15049,80111,7.16,19.03,22469459
244,2024-09-01,4643,5268837,40,27039,7765,1238153,673,8,-9,29,4630,84741,6.07,16.33,22469512
245,2024-09-08,4320,5273157,33,27072,7450,1245603,594,9,-5,24,2966,87707,5.49,15.02,22470210
246,2024-09-15,3897,5277054,25,27097,7170,1252773,595,8,1,25,-5281,82426,5.25,15.05,22470313
247,2024-09-22,4310,5281364,18,27115,8617,1261390,509,6,0,25,7742,90168,5.33,16.14,22472502
248,2024-09-29,5202,5286566,36,27151,11159,1272549,672,10,-2,23,5072,95240,6.11,19.33,22474102
249,2024-10-06,5126,5291692,25,27176,10532,1283081,613,6,0,23,7317,102557,5.54,17.04,22476718
250,2024-10-13,4792,5296484,31,27207,9318,1292399,709,6,-3,20,-1846,100711,5.28,15.61,22479760
251,2024-10-20,3669,5300153,23,27230,7093,1299492,580,6,3,23,-8393,92318,4.41,13.03,22483383
252,2024-10-27,3135,5303288,27,27257,5861,1305353,538,6,-6,17,-7778,84540,4.13,11.91,22485804
253,2024-11-03,2950,5306238,17,27274,5794,1311147,547,17,7,24,-4633,79907,4.08,12.23,22489979
254,2024-11-10,2821,5309059,22,27296,5089,1316236,538,10,4,28,5122,85029,3.69,10.42,22494127
255,2024-11-17,2868,5311927,30,27326,5007,1321243,531,8,-4,24,-591,84438,3.77,10.43,22498233
256,2024-11-24,2936,5314863,28,27354,5280,1326523,614,13,-2,22,-3018,81420,4.02,11.32,22502638
257,2024-12-01,2755,5317618,31,27385,4950,1331473,577,6,4,26,-2469,78951,3.88,10.93,22506841
258,2024-12-08,2860,5320478,35,27420,4872,1336345,632,13,-5,21,-1347,77604,4.07,11.13,22510957
259,2024-12-15,2614,5323092,18,27438,4631,1340976,514,9,2,23,864,78468,3.69,10.34,22514528
260,2024-12-22,2427,5325519,31,27469,5861,1346837,532,8,0,23,1574,80042,3.00,10.34,22516413
261,2024-12-29,2203,5327722,24,27493,3428,1350265,515,5,3,26,-29823,50219,4.88,12.67,22517254
262,2025-01-05,2826,5330548,26,27519,4452,1354717,538,12,0,26,6629,56848,5.43,14.33,22518467
263,2025-01-12,2898,5333446,28,27547,5059,1359776,648,10,4,30,16929,73777,4.35,12.04,22520979
264,2025-01-19,1719,5335165,28,27575,3009,1362785,418,11,-4,26,-6289,67488,2.81,7.83,22522135
265,2025-01-26,1187,5336352,23,27598,2236,1365021,382,11,-1,25,-7152,60336,2.17,6.32,22524268
266,2025-02-02,972,5337324,19,27617,1783,1366804,234,5,-4,21,2259,62595,1.72,4.91,22525410
267,2025-02-09,661,5337985,13,27630,1175,1367979,188,3,-1,20,-2628,59967,1.21,3.42,22525637
268,2025-02-16,582,5338567,10,27640,1029,1369008,170,0,-8,12,-284,59683,1.07,3.01,22526279
269,2025-02-23,468,5339035,7,27647,974,1369982,126,1,-4,8,-2331,57352,0.91,2.81,22526708
270,2025-03-02,431,5339466,5,27652,853,1370835,153,3,1,9,-4689,52663,0.89,2.73,22527169
271,2025-03-09,383,5339849,6,27658,711,1371546,90,1,-2,7,2890,55553,0.77,2.20,22527434
272,2025-03-16,984,5340833,4,27662,195,1371741,90,3,1,8,-2446,53107,1.83,2.22,22527616
273,2025-03-23,731,5341564,6,27668,116,1371857,90,1,1,9,-6242,46865,1.55,1.80,22527653
274,2025-03-30,547,5342111,5,27673,-10,1371847,83,3,-2,7,-6380,40485,1.32,1.32,22527811
275,2025-04-06,597,5342708,2,27675,0,1371847,56,1,-3,4,4801,45286,1.30,1.32,22527907
276,2025-04-13,618,5343326,1,27676,0,1371847,58,2,0,4,-2492,42794,1.40,1.44,22527973
277,2025-04-20,381,5343707,3,27679,6,1371853,42,2,1,5,-15493,27301,1.38,1.42,22527980
278,2025-04-27,485,5344192,2,27681,8,1371861,63,1,0,5,3417,30718,1.56,1.60,22527980
279,2025-05-04,513,5344705,0,27681,8,1371861,53,2,0,5,3155,33873,1.48,1.53,22527980
280,2025-05-11,691,5345396,1,27682,5,1371866,47,0,-2,3,4579,38452,1.79,1.80,22527980
281,2025-05-18,693,5346089,2,27684,2,1371868,50,0,-2,1,-2171,36281,1.90,1.90,22527980
282,2025-05-25,755,5346844,3,27687,0,1371868,53,0,0,0,111,36392,2.07,2.07,22527980
283,2025-06-01,913,5347757,1,27688,0,1371868,56,1,0,0,33,36425,2.51,2.49,22527980
284,2025-06-08,1076,5348833,0,27688,0,1371868,90,2,0,,-4306,32119,3.35,,22527980
285,2025-06-15,953,5349786,3,27691,0,1371868,63,1,0,,-4674,27445,3.47,,22527980
286,2025-06-22,1093,5350879,2,27693,0,1371868,73,1,0,,3564,31009,3.52,,22527980
